Day,ActiveMode,ActiveModeCounterToInactiveNorm,InactiveModeCounterToActiveNorm,ActiveNorm,Rain
0,7893,0,0,7893,1
1,7581,0,312,7893,0
2,7534,0,359,7893,0
3,7534,0,357,7891,0
7,7033,0,840,7873,1
8,6765,0,1056,7821,1
9,6364,0,1249,7613,1
10,6343,0,1167,7510,1
14,6441,0,916,7357,0
15,6277,0,967,7244,1
16,6343,0,652,6995,0
17,6277,0,501,6778,1
21,6277,0,351,6628,0
22,6277,0,181,6458,0
23,6277,0,160,6437,0
24,6277,0,128,6405,0
28,6277,0,72,6349,0
29,6277,0,41,6318,0
30,6277,0,16,6293,0
31,6277,0,0,6277,0
35,6277,0,0,6277,0
36,6277,0,0,6277,1
37,6277,0,0,6277,0
38,6277,0,0,6277,0
42,6277,0,0,6277,1
43,6277,0,0,6277,0
44,6277,0,0,6277,0
45,6277,0,0,6277,0
49,6277,0,0,6277,0
50,6277,0,0,6277,0
51,6277,0,0,6277,1
52,6277,0,0,6277,0
56,6277,0,0,6277,0
57,6277,0,0,6277,1
58,6277,0,0,6277,0
59,6277,0,0,6277,0
63,6277,0,0,6277,0
64,6277,0,0,6277,1
65,6277,0,0,6277,0
66,6277,0,0,6277,0
70,6277,0,0,6277,0
71,6277,0,0,6277,1
72,6277,0,0,6277,1
73,6277,0,0,6277,1
77,6277,0,0,6277,0
78,6277,0,0,6277,1
79,6277,0,0,6277,0
80,6277,0,0,6277,1
84,6277,0,0,6277,0
85,6277,0,0,6277,0
86,6277,0,0,6277,1
87,6277,0,0,6277,0
91,6277,0,0,6277,0
92,6277,0,0,6277,1
93,6277,0,0,6277,1
94,6277,0,0,6277,1
98,6277,0,0,6277,0
99,6277,0,0,6277,1
100,6277,0,0,6277,0
101,6277,0,0,6277,0
105,6277,0,0,6277,0
106,6277,0,0,6277,1
107,6277,0,0,6277,1
108,6277,0,0,6277,0
112,6277,0,0,6277,0
113,6277,0,0,6277,1
114,6277,0,0,6277,0
115,6277,0,0,6277,0
119,6277,0,0,6277,1
120,6277,0,0,6277,0
121,6277,0,0,6277,0
122,6277,0,0,6277,0
126,6277,0,0,6277,0
127,6277,0,0,6277,1
128,6277,0,0,6277,0
129,6277,0,0,6277,0
133,6277,0,0,6277,0
134,6277,0,0,6277,1
135,6277,0,0,6277,0
136,6277,0,0,6277,0
140,6277,0,0,6277,0
141,6277,0,0,6277,0
142,6277,0,0,6277,0
143,6277,0,0,6277,1
147,6277,0,0,6277,0
148,6277,0,0,6277,0
149,6277,0,0,6277,0
150,6277,0,0,6277,0
154,6277,0,0,6277,0
155,6277,0,0,6277,1
156,6277,0,0,6277,0
157,6277,0,0,6277,0
161,6277,0,0,6277,0
162,6277,0,0,6277,0
163,6277,0,0,6277,0
164,6277,0,0,6277,1
168,6277,0,0,6277,0
169,6277,0,0,6277,1
170,6277,0,0,6277,0
171,6277,0,0,6277,0
175,6277,0,0,6277,1
176,6277,0,0,6277,0
177,6277,0,0,6277,1
178,6277,0,0,6277,1
182,6277,0,0,6277,0
183,6277,0,0,6277,0
184,6277,0,0,6277,0
185,6277,0,0,6277,0
189,6277,0,0,6277,0
190,6277,0,0,6277,0
191,6277,0,0,6277,0
192,6277,0,0,6277,0
196,6277,0,0,6277,0
197,6277,0,0,6277,1
198,6277,0,0,6277,1
199,6277,0,0,6277,1
203,6277,0,0,6277,0
204,6277,0,0,6277,0
205,6277,0,0,6277,0
206,6277,0,0,6277,0
210,6277,0,0,6277,0
211,6277,0,0,6277,0
212,6277,0,0,6277,1
213,6277,0,0,6277,0
217,6277,0,0,6277,0
218,6277,0,0,6277,0
219,6277,0,0,6277,1
220,6277,0,0,6277,1
224,6277,0,0,6277,0
225,6277,0,0,6277,0
226,6277,0,0,6277,0
227,6277,0,0,6277,0
231,6277,0,0,6277,0
232,6277,0,0,6277,0
233,6277,0,0,6277,0
234,6277,0,0,6277,0
238,6277,0,0,6277,1
239,6277,0,0,6277,1
240,6277,0,0,6277,1
241,6277,0,0,6277,0
245,6277,0,0,6277,1
246,6277,0,0,6277,0
247,6277,0,0,6277,0
248,6277,0,0,6277,0
252,6277,0,0,6277,1
253,6277,0,0,6277,1
254,6277,0,0,6277,0
255,6277,0,0,6277,0
259,6277,0,0,6277,0
260,6277,0,0,6277,0
261,6277,0,0,6277,1
262,6277,0,0,6277,0
266,6277,0,0,6277,0
267,6277,0,0,6277,0
268,6277,0,0,6277,1
269,6277,0,0,6277,1
273,6277,0,0,6277,0
274,6277,0,0,6277,1
275,6277,0,0,6277,1
276,6277,0,0,6277,0
280,6277,0,0,6277,1
281,6277,0,0,6277,0
282,6277,0,0,6277,0
283,6277,0,0,6277,0
287,6277,0,0,6277,0
288,6277,0,0,6277,0
289,6277,0,0,6277,1
290,6277,0,0,6277,1
294,6277,0,0,6277,0
295,6277,0,0,6277,1
296,6277,0,0,6277,0
297,6277,0,0,6277,1
301,6277,0,0,6277,0
302,6277,0,0,6277,0
303,6277,0,0,6277,1
304,6277,0,0,6277,0
308,6277,0,0,6277,0
309,6277,0,0,6277,1
310,6277,0,0,6277,0
311,6277,0,0,6277,0
315,6277,0,0,6277,1
316,6277,0,0,6277,0
317,6277,0,0,6277,0
318,6277,0,0,6277,0
322,6277,0,0,6277,1
323,6277,0,0,6277,0
324,6277,0,0,6277,0
325,6277,0,0,6277,0
329,6277,0,0,6277,0
330,6277,0,0,6277,0
331,6277,0,0,6277,0
332,6277,0,0,6277,0
336,6277,0,0,6277,0
337,6277,0,0,6277,1
338,6277,0,0,6277,0
339,6277,0,0,6277,0
343,6277,0,0,6277,0
344,6277,0,0,6277,0
345,6277,0,0,6277,1
346,6277,0,0,6277,0
350,6277,0,0,6277,0
351,6277,0,0,6277,0
352,6277,0,0,6277,0
353,6277,0,0,6277,1
357,6277,0,0,6277,0
358,6277,0,0,6277,0
359,6277,0,0,6277,0
360,6277,0,0,6277,0
364,6277,0,0,6277,0
365,6277,0,0,6277,0
