Day,Rain,ActiveMode,ActiveNorm,ActiveModeCounterToInactiveNorm,InactiveModeCounterToActiveNorm,LocalCommute,CityCommute,DistantCommute,Subculture A,Subculture B,Subculture C,0,1,4,3
0,0,49393,49393,0,0,28723,20670,0,16440,0,32953,8229,12315,12482,16367
1,0,49385,42598,24153,17366,28723,20662,0,16440,0,32945,8226,12310,12482,16367
2,1,37361,42595,16772,22006,27122,10239,0,14127,0,23234,4058,6771,11653,14879
3,0,48878,17641,37284,6047,28703,20175,0,16419,0,32459,8024,12008,12480,16366
4,1,37313,41776,16926,21389,27086,10227,0,14087,0,23226,4058,6737,11647,14871
7,0,47505,17539,35974,6008,28582,18923,0,16283,0,31222,7453,11265,12459,16328
8,0,48002,39318,24252,15568,28638,19364,0,16341,0,31661,7603,11602,12461,16336
9,0,48004,40305,23742,16043,28638,19366,0,16341,0,31663,7603,11604,12461,16336
10,1,37192,40304,17258,20370,27014,10178,0,13997,0,23195,4058,6670,11625,14839
11,0,45606,17368,34218,5980,28328,17278,0,15981,0,29625,6745,10224,12417,16220
14,1,36719,34917,18647,16845,26733,9986,0,13649,0,23070,4058,6404,11564,14693
15,1,35461,16410,26020,6969,25967,9494,0,12676,0,22785,4056,5679,11455,14271
16,1,35103,14359,26632,5888,25760,9343,0,12404,0,22699,4056,5475,11449,14123
17,1,34962,13741,26812,5591,25677,9285,0,12291,0,22671,4056,5397,11439,14070
18,1,34920,13538,26890,5508,25651,9269,0,12254,0,22666,4056,5371,11438,14055
21,1,34903,13484,26899,5480,25643,9260,0,12242,0,22661,4056,5363,11438,14046
22,0,35269,13464,27279,5474,25843,9426,0,12517,0,22752,4058,5565,11455,14191
23,0,35273,14033,26969,5729,25846,9427,0,12521,0,22752,4058,5568,11455,14192
24,0,35273,14044,26964,5735,25846,9427,0,12521,0,22752,4058,5568,11455,14192
25,0,35273,14059,26950,5736,25846,9427,0,12521,0,22752,4058,5568,11455,14192
28,0,35273,14061,26945,5733,25846,9427,0,12521,0,22752,4058,5568,11455,14192
29,0,35273,14048,26966,5741,25846,9427,0,12521,0,22752,4058,5568,11455,14192
30,0,35273,14052,26959,5738,25846,9427,0,12521,0,22752,4058,5568,11455,14192
31,1,32877,14061,24616,5800,24950,7927,0,11087,0,21790,4055,4792,10984,13046
32,0,35263,10306,29108,4151,25841,9422,0,12512,0,22751,4058,5563,11455,14187
35,1,32874,14021,24638,5785,24949,7925,0,11085,0,21789,4055,4791,10984,13044
36,0,35143,10299,28997,4153,25769,9374,0,12415,0,22728,4058,5494,11451,14140
37,1,32812,13803,24679,5670,24921,7891,0,11043,0,21769,4055,4766,10979,13012
38,1,32575,10222,26505,4152,24853,7722,0,10900,0,21675,4055,4709,10968,12843
39,1,32549,9996,26614,4061,24847,7702,0,10886,0,21663,4055,4704,10968,12822
42,1,32544,9966,26635,4057,24846,7698,0,10883,0,21661,4055,4703,10968,12818
43,0,32851,9973,26928,4050,24928,7923,0,11058,0,21793,4055,4781,10992,13023
44,0,32852,10283,26760,4191,24928,7924,0,11058,0,21794,4055,4781,10992,13024
45,0,32852,10283,26749,4180,24928,7924,0,11058,0,21794,4055,4781,10992,13024
46,0,32852,10295,26742,4185,24928,7924,0,11058,0,21794,4055,4781,10992,13024
49,0,32852,10281,26746,4175,24928,7924,0,11058,0,21794,4055,4781,10992,13024
50,1,31571,10302,25475,4206,24622,6949,0,10334,0,21237,4055,4535,10810,12171
51,1,31420,8303,26545,3428,24588,6832,0,10241,0,21179,4055,4506,10806,12053
52,0,32656,8191,27841,3376,24877,7779,0,10949,0,21707,4055,4734,10978,12889
53,0,32657,10110,26655,4108,24877,7780,0,10949,0,21708,4055,4734,10978,12890
56,0,32657,10099,26659,4101,24877,7780,0,10949,0,21708,4055,4734,10978,12890
57,0,32657,10119,26649,4111,24877,7780,0,10949,0,21708,4055,4734,10978,12890
58,0,32657,10105,26653,4101,24877,7780,0,10949,0,21708,4055,4734,10978,12890
59,1,31376,10107,25415,4146,24581,6795,0,10219,0,21157,4055,4502,10796,12023
60,0,32651,8117,27876,3342,24873,7778,0,10949,0,21702,4055,4730,10978,12888
63,0,32651,10091,26661,4101,24873,7778,0,10949,0,21702,4055,4730,10978,12888
64,0,32651,10102,26655,4106,24873,7778,0,10949,0,21702,4055,4730,10978,12888
65,0,32651,10105,26662,4116,24873,7778,0,10949,0,21702,4055,4730,10978,12888
66,1,31375,10107,25412,4144,24581,6794,0,10219,0,21156,4055,4502,10795,12023
67,0,32646,8114,27873,3341,24870,7776,0,10944,0,21702,4055,4730,10978,12883
70,0,32647,10105,26646,4104,24870,7777,0,10945,0,21702,4055,4730,10978,12884
71,0,32647,10099,26659,4111,24870,7777,0,10945,0,21702,4055,4730,10978,12884
72,0,32647,10097,26651,4101,24870,7777,0,10945,0,21702,4055,4730,10978,12884
73,0,32647,10093,26654,4100,24870,7777,0,10945,0,21702,4055,4730,10978,12884
74,0,32647,10104,26644,4101,24870,7777,0,10945,0,21702,4055,4730,10978,12884
77,1,31374,10100,25407,4133,24581,6793,0,10219,0,21155,4055,4502,10795,12022
78,0,32646,8117,27872,3343,24870,7776,0,10944,0,21702,4055,4730,10978,12883
79,1,31374,10099,25410,4135,24581,6793,0,10219,0,21155,4055,4502,10795,12022
80,0,32512,8107,27742,3337,24801,7711,0,10846,0,21666,4055,4710,10938,12809
81,0,32540,9969,26627,4056,24807,7733,0,10863,0,21677,4055,4716,10938,12831
84,0,32540,9986,26615,4061,24807,7733,0,10863,0,21677,4055,4716,10938,12831
85,1,31347,9997,25455,4105,24576,6771,0,10206,0,21141,4055,4500,10786,12006
86,0,32412,8024,27691,3303,24777,7635,0,10782,0,21630,4055,4695,10928,12734
87,0,32433,9840,26586,3993,24781,7652,0,10798,0,21635,4055,4699,10928,12751
88,1,31318,9857,25493,4032,24571,6747,0,10192,0,21126,4054,4498,10781,11985
91,1,31262,7997,26564,3299,24559,6703,0,10162,0,21100,4054,4491,10779,11938
92,0,31445,7959,26772,3286,24583,6862,0,10225,0,21220,4055,4504,10858,12028
93,0,31445,8183,26638,3376,24583,6862,0,10225,0,21220,4055,4504,10858,12028
94,0,31445,8204,26627,3386,24583,6862,0,10225,0,21220,4055,4504,10858,12028
95,1,30534,8193,25743,3402,24461,6073,0,9790,0,20744,4054,4430,10714,11336
98,0,31438,7079,27318,2959,24581,6857,0,10222,0,21216,4054,4503,10856,12025
99,1,30534,8195,25736,3397,24461,6073,0,9790,0,20744,4054,4430,10714,11336
100,0,31371,7092,27245,2966,24572,6799,0,10211,0,21160,4054,4501,10798,12018
101,0,31371,8100,26619,3348,24572,6799,0,10211,0,21160,4054,4501,10798,12018
102,0,31371,8098,26614,3341,24572,6799,0,10211,0,21160,4054,4501,10798,12018
105,1,30508,8108,25760,3360,24453,6055,0,9776,0,20732,4054,4426,10699,11329
106,1,30407,7052,26313,2958,24433,5974,0,9716,0,20691,4054,4410,10699,11244
107,0,31228,6994,27163,2929,24524,6704,0,10127,0,21101,4054,4490,10772,11912
108,1,30334,7939,25689,3294,24427,5907,0,9679,0,20655,4054,4406,10696,11178
109,1,30308,6892,26322,2906,24420,5888,0,9664,0,20644,4054,4401,10695,11158
112,0,30562,6871,26585,2894,24455,6107,0,9786,0,20776,4054,4432,10736,11340
113,0,30562,7093,26443,2974,24455,6107,0,9786,0,20776,4054,4432,10736,11340
114,0,30562,7099,26436,2973,24455,6107,0,9786,0,20776,4054,4432,10736,11340
115,0,30562,7091,26443,2972,24455,6107,0,9786,0,20776,4054,4432,10736,11340
116,1,29860,7100,25755,2995,24356,5504,0,9403,0,20457,4054,4371,10651,10784
119,0,30552,6403,26866,2717,24453,6099,0,9780,0,20772,4054,4430,10736,11332
120,1,29858,7096,25753,2991,24356,5502,0,9402,0,20456,4054,4371,10651,10782
121,0,30479,6400,26792,2713,24444,6035,0,9744,0,20735,4054,4423,10726,11276
122,0,30481,7050,26392,2961,24444,6037,0,9745,0,20736,4054,4423,10726,11278
123,1,29830,7035,25766,2971,24353,5477,0,9391,0,20439,4054,4370,10647,10759
126,0,30407,6380,26739,2712,24426,5981,0,9709,0,20698,4054,4410,10710,11233
127,0,30409,6985,26353,2929,24427,5982,0,9710,0,20699,4054,4411,10710,11234
128,1,29807,6997,25759,2949,24351,5456,0,9379,0,20428,4054,4369,10640,10744
129,0,30358,6371,26701,2714,24402,5956,0,9677,0,20681,4054,4405,10702,11197
130,1,29796,6976,25761,2941,24351,5445,0,9374,0,20422,4054,4369,10638,10735
133,1,29745,6346,26111,2712,24337,5408,0,9336,0,20409,4054,4358,10637,10696
134,0,29908,6330,26278,2700,24358,5550,0,9418,0,20490,4054,4375,10674,10805
135,0,29909,6447,26211,2749,24358,5551,0,9418,0,20491,4054,4375,10674,10806
136,0,29909,6449,26205,2745,24358,5551,0,9418,0,20491,4054,4375,10674,10806
137,0,29909,6451,26200,2742,24358,5551,0,9418,0,20491,4054,4375,10674,10806
140,0,29909,6453,26205,2749,24358,5551,0,9418,0,20491,4054,4375,10674,10806
141,0,29909,6459,26203,2753,24358,5551,0,9418,0,20491,4054,4375,10674,10806
142,1,29480,6448,25788,2756,24302,5178,0,9202,0,20278,4054,4340,10607,10479
143,0,29905,6112,26407,2614,24357,5548,0,9417,0,20488,4054,4374,10674,10803
144,1,29480,6444,25789,2753,24302,5178,0,9202,0,20278,4054,4340,10607,10479
147,0,29895,6117,26399,2621,24353,5542,0,9410,0,20485,4054,4374,10672,10795
148,1,29479,6450,25782,2753,24302,5177,0,9201,0,20278,4054,4340,10607,10478
149,1,29457,6124,25958,2625,24299,5158,0,9189,0,20268,4054,4339,10606,10458
150,1,29455,6103,25977,2625,24299,5156,0,9188,0,20267,4054,4339,10606,10456
151,1,29454,6117,25964,2627,24299,5155,0,9188,0,20266,4054,4339,10606,10455
154,1,29454,6108,25968,2622,24299,5155,0,9188,0,20266,4054,4339,10606,10455
155,0,29466,6093,25987,2614,24299,5167,0,9193,0,20273,4054,4339,10606,10467
156,1,29244,6122,25757,2635,24268,4976,0,9077,0,20167,4054,4323,10577,10290
157,1,29229,5944,25861,2576,24263,4966,0,9066,0,20163,4054,4320,10573,10282
158,0,29455,5936,26090,2571,24299,5156,0,9188,0,20267,4054,4339,10606,10456
161,0,29455,6110,25977,2632,24299,5156,0,9188,0,20267,4054,4339,10606,10456
162,1,29225,6113,25746,2634,24263,4962,0,9064,0,20161,4054,4320,10573,10278
163,0,29452,5929,26088,2565,24296,5156,0,9186,0,20266,4054,4338,10606,10454
164,0,29452,6096,25975,2619,24296,5156,0,9186,0,20266,4054,4338,10606,10454
165,0,29452,6107,25973,2628,24296,5156,0,9186,0,20266,4054,4338,10606,10454
168,0,29452,6094,25967,2609,24296,5156,0,9186,0,20266,4054,4338,10606,10454
169,0,29452,6098,25973,2619,24296,5156,0,9186,0,20266,4054,4338,10606,10454
170,0,29452,6110,25966,2624,24296,5156,0,9186,0,20266,4054,4338,10606,10454
171,0,29452,6103,25972,2623,24296,5156,0,9186,0,20266,4054,4338,10606,10454
172,0,29452,6095,25977,2620,24296,5156,0,9186,0,20266,4054,4338,10606,10454
175,1,29225,6095,25752,2622,24263,4962,0,9064,0,20161,4054,4320,10573,10278
176,1,29225,5927,25863,2565,24263,4962,0,9064,0,20161,4054,4320,10573,10278
177,1,29225,5934,25859,2568,24263,4962,0,9064,0,20161,4054,4320,10573,10278
178,0,29378,5933,26015,2570,24276,5102,0,9138,0,20240,4054,4333,10596,10395
179,0,29378,6059,25921,2602,24276,5102,0,9138,0,20240,4054,4333,10596,10395
182,0,29378,6043,25925,2590,24276,5102,0,9138,0,20240,4054,4333,10596,10395
183,0,29378,6057,25931,2610,24276,5102,0,9138,0,20240,4054,4333,10596,10395
184,0,29378,6054,25926,2602,24276,5102,0,9138,0,20240,4054,4333,10596,10395
185,0,29378,6050,25935,2607,24276,5102,0,9138,0,20240,4054,4333,10596,10395
186,0,29378,6072,25927,2621,24276,5102,0,9138,0,20240,4054,4333,10596,10395
189,0,29378,6056,25922,2600,24276,5102,0,9138,0,20240,4054,4333,10596,10395
190,0,29378,6059,25925,2606,24276,5102,0,9138,0,20240,4054,4333,10596,10395
191,0,29378,6054,25926,2602,24276,5102,0,9138,0,20240,4054,4333,10596,10395
192,0,29378,6050,25924,2596,24276,5102,0,9138,0,20240,4054,4333,10596,10395
193,0,29378,6044,25933,2599,24276,5102,0,9138,0,20240,4054,4333,10596,10395
196,0,29378,6044,25932,2598,24276,5102,0,9138,0,20240,4054,4333,10596,10395
197,0,29378,6056,25923,2601,24276,5102,0,9138,0,20240,4054,4333,10596,10395
198,0,29378,6053,25927,2602,24276,5102,0,9138,0,20240,4054,4333,10596,10395
199,0,29378,6061,25917,2600,24276,5102,0,9138,0,20240,4054,4333,10596,10395
200,0,29378,6055,25930,2607,24276,5102,0,9138,0,20240,4054,4333,10596,10395
203,0,29378,6059,25917,2598,24276,5102,0,9138,0,20240,4054,4333,10596,10395
204,0,29378,6059,25925,2606,24276,5102,0,9138,0,20240,4054,4333,10596,10395
205,0,29378,6062,25926,2610,24276,5102,0,9138,0,20240,4054,4333,10596,10395
206,1,29215,6054,25765,2604,24261,4954,0,9058,0,20157,4054,4319,10572,10270
207,0,29378,5915,26027,2564,24276,5102,0,9138,0,20240,4054,4333,10596,10395
210,1,29215,6060,25759,2604,24261,4954,0,9058,0,20157,4054,4319,10572,10270
211,0,29378,5924,26023,2569,24276,5102,0,9138,0,20240,4054,4333,10596,10395
212,0,29378,6057,25924,2603,24276,5102,0,9138,0,20240,4054,4333,10596,10395
213,0,29378,6046,25929,2597,24276,5102,0,9138,0,20240,4054,4333,10596,10395
214,0,29378,6051,25922,2595,24276,5102,0,9138,0,20240,4054,4333,10596,10395
217,0,29378,6054,25926,2602,24276,5102,0,9138,0,20240,4054,4333,10596,10395
218,0,29378,6052,25929,2603,24276,5102,0,9138,0,20240,4054,4333,10596,10395
219,0,29378,6050,25923,2595,24276,5102,0,9138,0,20240,4054,4333,10596,10395
220,0,29378,6069,25924,2615,24276,5102,0,9138,0,20240,4054,4333,10596,10395
221,0,29378,6069,25928,2619,24276,5102,0,9138,0,20240,4054,4333,10596,10395
224,0,29378,6047,25925,2594,24276,5102,0,9138,0,20240,4054,4333,10596,10395
225,0,29378,6064,25923,2609,24276,5102,0,9138,0,20240,4054,4333,10596,10395
226,1,29215,6053,25768,2606,24261,4954,0,9058,0,20157,4054,4319,10572,10270
227,0,29378,5924,26025,2571,24276,5102,0,9138,0,20240,4054,4333,10596,10395
228,0,29378,6050,25925,2597,24276,5102,0,9138,0,20240,4054,4333,10596,10395
231,1,29215,6047,25766,2598,24261,4954,0,9058,0,20157,4054,4319,10572,10270
232,0,29378,5923,26028,2573,24276,5102,0,9138,0,20240,4054,4333,10596,10395
233,1,29215,6050,25764,2599,24261,4954,0,9058,0,20157,4054,4319,10572,10270
234,0,29378,5926,26032,2580,24276,5102,0,9138,0,20240,4054,4333,10596,10395
235,1,29215,6057,25766,2608,24261,4954,0,9058,0,20157,4054,4319,10572,10270
238,0,29371,5919,26026,2574,24273,5098,0,9132,0,20239,4054,4331,10595,10391
239,0,29371,6063,25914,2606,24273,5098,0,9132,0,20239,4054,4331,10595,10391
240,0,29371,6053,25925,2607,24273,5098,0,9132,0,20239,4054,4331,10595,10391
241,0,29371,6055,25926,2610,24273,5098,0,9132,0,20239,4054,4331,10595,10391
242,0,29371,6060,25918,2607,24273,5098,0,9132,0,20239,4054,4331,10595,10391
245,0,29371,6055,25920,2604,24273,5098,0,9132,0,20239,4054,4331,10595,10391
246,0,29371,6068,25922,2619,24273,5098,0,9132,0,20239,4054,4331,10595,10391
247,1,29215,6053,25765,2603,24261,4954,0,9058,0,20157,4054,4319,10572,10270
248,0,29371,5937,26010,2576,24273,5098,0,9132,0,20239,4054,4331,10595,10391
249,0,29371,6050,25922,2601,24273,5098,0,9132,0,20239,4054,4331,10595,10391
252,1,29215,6047,25766,2598,24261,4954,0,9058,0,20157,4054,4319,10572,10270
253,0,29371,5908,26025,2562,24273,5098,0,9132,0,20239,4054,4331,10595,10391
254,0,29371,6052,25929,2610,24273,5098,0,9132,0,20239,4054,4331,10595,10391
255,1,29215,6063,25758,2606,24261,4954,0,9058,0,20157,4054,4319,10572,10270
256,0,29365,5920,26015,2570,24273,5092,0,9128,0,20237,4054,4331,10593,10387
259,1,29213,6056,25758,2601,24261,4952,0,9057,0,20156,4054,4319,10572,10268
260,1,29213,5912,25871,2570,24261,4952,0,9057,0,20156,4054,4319,10572,10268
261,0,29215,5911,25868,2564,24261,4954,0,9058,0,20157,4054,4319,10572,10270
262,0,29215,5923,25862,2570,24261,4954,0,9058,0,20157,4054,4319,10572,10270
263,1,29116,5929,25765,2578,24246,4870,0,9007,0,20109,4054,4310,10560,10192
266,0,29215,5844,25924,2553,24261,4954,0,9058,0,20157,4054,4319,10572,10270
267,1,29116,5917,25771,2572,24246,4870,0,9007,0,20109,4054,4310,10560,10192
268,0,29215,5834,25919,2538,24261,4954,0,9058,0,20157,4054,4319,10572,10270
269,0,29215,5928,25862,2575,24261,4954,0,9058,0,20157,4054,4319,10572,10270
270,0,29215,5926,25863,2574,24261,4954,0,9058,0,20157,4054,4319,10572,10270
273,0,29215,5919,25865,2569,24261,4954,0,9058,0,20157,4054,4319,10572,10270
274,0,29215,5931,25854,2570,24261,4954,0,9058,0,20157,4054,4319,10572,10270
275,0,29215,5923,25865,2573,24261,4954,0,9058,0,20157,4054,4319,10572,10270
276,1,29116,5934,25759,2577,24246,4870,0,9007,0,20109,4054,4310,10560,10192
277,0,29215,5834,25929,2548,24261,4954,0,9058,0,20157,4054,4319,10572,10270
280,0,29215,5925,25855,2565,24261,4954,0,9058,0,20157,4054,4319,10572,10270
281,0,29215,5918,25862,2565,24261,4954,0,9058,0,20157,4054,4319,10572,10270
282,0,29215,5926,25860,2571,24261,4954,0,9058,0,20157,4054,4319,10572,10270
283,0,29215,5941,25854,2580,24261,4954,0,9058,0,20157,4054,4319,10572,10270
284,0,29215,5930,25857,2572,24261,4954,0,9058,0,20157,4054,4319,10572,10270
287,0,29215,5931,25864,2580,24261,4954,0,9058,0,20157,4054,4319,10572,10270
288,0,29215,5937,25853,2575,24261,4954,0,9058,0,20157,4054,4319,10572,10270
289,0,29215,5935,25856,2576,24261,4954,0,9058,0,20157,4054,4319,10572,10270
290,0,29215,5926,25863,2574,24261,4954,0,9058,0,20157,4054,4319,10572,10270
291,0,29215,5930,25869,2584,24261,4954,0,9058,0,20157,4054,4319,10572,10270
294,0,29215,5925,25864,2574,24261,4954,0,9058,0,20157,4054,4319,10572,10270
295,0,29215,5930,25866,2581,24261,4954,0,9058,0,20157,4054,4319,10572,10270
296,0,29215,5915,25866,2566,24261,4954,0,9058,0,20157,4054,4319,10572,10270
297,0,29215,5920,25866,2571,24261,4954,0,9058,0,20157,4054,4319,10572,10270
298,1,29116,5924,25759,2567,24246,4870,0,9007,0,20109,4054,4310,10560,10192
301,0,29215,5836,25920,2541,24261,4954,0,9058,0,20157,4054,4319,10572,10270
302,1,29116,5934,25763,2581,24246,4870,0,9007,0,20109,4054,4310,10560,10192
303,1,29108,5849,25804,2545,24243,4865,0,9001,0,20107,4054,4309,10560,10185
304,1,29108,5830,25813,2535,24243,4865,0,9001,0,20107,4054,4309,10560,10185
305,0,29177,5833,25882,2538,24249,4928,0,9032,0,20145,4054,4313,10568,10242
308,0,29177,5895,25845,2563,24249,4928,0,9032,0,20145,4054,4313,10568,10242
309,1,29095,5878,25767,2550,24241,4854,0,8991,0,20104,4054,4309,10557,10175
310,0,29136,5822,25857,2543,24244,4892,0,9013,0,20123,4054,4310,10568,10204
311,0,29136,5854,25829,2547,24244,4892,0,9013,0,20123,4054,4310,10568,10204
312,0,29136,5860,25831,2555,24244,4892,0,9013,0,20123,4054,4310,10568,10204
315,1,29063,5849,25762,2548,24238,4825,0,8979,0,20084,4054,4308,10552,10149
316,0,29135,5790,25879,2534,24244,4891,0,9012,0,20123,4054,4310,10568,10203
317,0,29135,5855,25829,2549,24244,4891,0,9012,0,20123,4054,4310,10568,10203
318,0,29135,5863,25828,2556,24244,4891,0,9012,0,20123,4054,4310,10568,10203
319,1,29060,5865,25748,2553,24238,4822,0,8977,0,20083,4054,4308,10552,10146
322,0,29135,5802,25873,2540,24244,4891,0,9012,0,20123,4054,4310,10568,10203
323,0,29135,5865,25822,2552,24244,4891,0,9012,0,20123,4054,4310,10568,10203
324,1,29060,5865,25750,2555,24238,4822,0,8977,0,20083,4054,4308,10552,10146
325,0,29123,5783,25873,2533,24244,4879,0,9005,0,20118,4054,4310,10568,10191
326,0,29123,5846,25822,2545,24244,4879,0,9005,0,20118,4054,4310,10568,10191
329,0,29123,5846,25823,2546,24244,4879,0,9005,0,20118,4054,4310,10568,10191
330,0,29123,5850,25818,2545,24244,4879,0,9005,0,20118,4054,4310,10568,10191
331,0,29123,5845,25827,2549,24244,4879,0,9005,0,20118,4054,4310,10568,10191
332,0,29123,5847,25821,2545,24244,4879,0,9005,0,20118,4054,4310,10568,10191
333,0,29123,5846,25821,2544,24244,4879,0,9005,0,20118,4054,4310,10568,10191
336,0,29123,5842,25833,2552,24244,4879,0,9005,0,20118,4054,4310,10568,10191
337,1,29052,5846,25756,2550,24236,4816,0,8973,0,20079,4054,4307,10551,10140
338,1,29049,5778,25798,2527,24235,4814,0,8970,0,20079,4054,4307,10551,10137
339,0,29120,5774,25873,2527,24241,4879,0,9002,0,20118,4054,4310,10566,10190
340,0,29120,5833,25829,2542,24241,4879,0,9002,0,20118,4054,4310,10566,10190
343,1,29048,5838,25753,2543,24235,4813,0,8970,0,20078,4054,4307,10550,10137
344,1,29048,5768,25808,2528,24235,4813,0,8970,0,20078,4054,4307,10550,10137
345,1,29048,5762,25814,2528,24235,4813,0,8970,0,20078,4054,4307,10550,10137
346,0,29055,5773,25815,2533,24236,4819,0,8973,0,20082,4054,4308,10552,10141
347,0,29055,5773,25803,2521,24236,4819,0,8973,0,20082,4054,4308,10552,10141
350,0,29055,5772,25806,2523,24236,4819,0,8973,0,20082,4054,4308,10552,10141
351,0,29055,5778,25808,2531,24236,4819,0,8973,0,20082,4054,4308,10552,10141
352,1,29014,5780,25768,2534,24231,4783,0,8952,0,20062,4054,4307,10541,10112
353,0,29055,5727,25837,2509,24236,4819,0,8973,0,20082,4054,4308,10552,10141
354,1,29014,5767,25775,2528,24231,4783,0,8952,0,20062,4054,4307,10541,10112
357,0,29051,5729,25828,2506,24235,4816,0,8971,0,20080,4054,4307,10552,10138
358,0,29051,5758,25808,2515,24235,4816,0,8971,0,20080,4054,4307,10552,10138
359,0,29051,5779,25802,2530,24235,4816,0,8971,0,20080,4054,4307,10552,10138
360,0,29051,5779,25800,2528,24235,4816,0,8971,0,20080,4054,4307,10552,10138
361,0,29051,5774,25806,2529,24235,4816,0,8971,0,20080,4054,4307,10552,10138
364,1,29013,5781,25765,2533,24231,4782,0,8952,0,20061,4054,4307,10541,10111
