Day,Rain,ActiveMode,ActiveNorm,ActiveModeCounterToInactiveNorm,InactiveModeCounterToActiveNorm,LocalCommute,CityCommute,DistantCommute,Subculture A,Subculture B,Subculture C,0,1,4,3
0,0,10008,10008,0,0,5822,4186,0,3320,0,6688,1702,2496,2446,3364
1,1,7659,9109,3230,4680,5524,2135,0,2889,0,4770,843,1412,2316,3088
2,0,9923,4023,7272,1372,5819,4104,0,3317,0,6606,1673,2441,2445,3364
3,0,9958,9002,4587,3631,5820,4138,0,3318,0,6640,1682,2467,2445,3364
4,0,9958,9056,4565,3663,5820,4138,0,3318,0,6640,1682,2467,2445,3364
7,0,9958,9044,4576,3662,5820,4138,0,3318,0,6640,1682,2467,2445,3364
8,0,9958,9054,4570,3666,5820,4138,0,3318,0,6640,1682,2467,2445,3364
9,1,7656,9060,3238,4642,5522,2134,0,2887,0,4769,843,1410,2316,3087
10,0,9737,4021,7087,1371,5804,3933,0,3298,0,6439,1594,2342,2443,3358
11,0,9828,8646,4615,3433,5814,4014,0,3310,0,6518,1625,2399,2443,3361
14,0,9828,8817,4528,3517,5814,4014,0,3310,0,6518,1625,2399,2443,3361
15,0,9828,8825,4525,3522,5814,4014,0,3310,0,6518,1625,2399,2443,3361
16,0,9828,8838,4517,3527,5814,4014,0,3310,0,6518,1625,2399,2443,3361
17,1,7641,8834,3279,4472,5514,2127,0,2877,0,4764,843,1402,2315,3081
18,0,9529,3990,6892,1353,5780,3749,0,3270,0,6259,1509,2230,2440,3350
21,1,7582,8220,3445,4083,5477,2105,0,2827,0,4755,843,1366,2311,3062
22,0,8942,3900,6388,1346,5702,3240,0,3178,0,5764,1276,1921,2430,3315
23,0,9005,6542,4939,2476,5712,3293,0,3190,0,5815,1292,1962,2430,3321
24,1,7416,6661,3871,3116,5387,2029,0,2706,0,4710,842,1277,2296,3001
25,1,7220,3608,5136,1524,5275,1945,0,2562,0,4658,842,1169,2286,2923
28,0,7841,3261,5827,1247,5512,2329,0,2895,0,4946,900,1448,2368,3125
29,0,7848,4288,5266,1706,5513,2335,0,2897,0,4951,901,1453,2368,3126
30,1,6985,4303,4501,1819,5169,1816,0,2402,0,4583,842,1077,2240,2826
31,0,7690,2808,5954,1072,5474,2216,0,2839,0,4851,873,1387,2346,3084
32,0,7694,4053,5303,1662,5475,2219,0,2840,0,4854,873,1389,2346,3086
35,0,7694,4068,5291,1665,5475,2219,0,2840,0,4854,873,1389,2346,3086
36,0,7694,4059,5295,1660,5475,2219,0,2840,0,4854,873,1389,2346,3086
37,0,7694,4070,5285,1661,5475,2219,0,2840,0,4854,873,1389,2346,3086
38,0,7694,4064,5291,1661,5475,2219,0,2840,0,4854,873,1389,2346,3086
39,1,6941,4058,4604,1721,5155,1786,0,2375,0,4566,842,1064,2235,2800
42,0,7686,2705,5997,1016,5471,2215,0,2836,0,4850,873,1385,2345,3083
43,0,7689,4056,5288,1655,5473,2216,0,2838,0,4851,873,1388,2345,3083
44,0,7689,4054,5291,1656,5473,2216,0,2838,0,4851,873,1388,2345,3083
45,1,6940,4051,4608,1719,5154,1786,0,2374,0,4566,842,1063,2235,2800
46,0,7652,2693,5968,1009,5449,2203,0,2808,0,4844,873,1364,2345,3070
49,1,6933,3982,4635,1684,5150,1783,0,2368,0,4565,842,1060,2234,2797
50,0,7500,2679,5834,1013,5341,2159,0,2679,0,4821,873,1267,2332,3028
51,1,6885,3700,4725,1540,5133,1752,0,2340,0,4545,842,1043,2228,2772
52,1,6817,2605,5244,1032,5109,1708,0,2294,0,4523,842,1021,2224,2730
53,1,6809,2529,5279,999,5108,1701,0,2290,0,4519,842,1020,2224,2723
56,1,6807,2520,5287,1000,5107,1700,0,2288,0,4519,842,1019,2224,2722
57,1,6807,2521,5283,997,5107,1700,0,2288,0,4519,842,1019,2224,2722
58,1,6807,2522,5284,999,5107,1700,0,2288,0,4519,842,1019,2224,2722
59,1,6807,2525,5283,1001,5107,1700,0,2288,0,4519,842,1019,2224,2722
60,0,6808,2519,5285,996,5107,1701,0,2289,0,4519,842,1019,2224,2723
63,1,6546,2534,5019,1007,5036,1510,0,2136,0,4410,842,960,2178,2566
64,0,6807,2067,5558,818,5107,1700,0,2288,0,4519,842,1019,2224,2722
65,1,6544,2517,5025,998,5036,1508,0,2134,0,4410,842,960,2178,2564
66,0,6807,2068,5556,817,5107,1700,0,2288,0,4519,842,1019,2224,2722
67,0,6807,2519,5289,1001,5107,1700,0,2288,0,4519,842,1019,2224,2722
70,1,6544,2522,5022,1000,5036,1508,0,2134,0,4410,842,960,2178,2564
71,0,6807,2065,5554,812,5107,1700,0,2288,0,4519,842,1019,2224,2722
72,0,6807,2524,5282,999,5107,1700,0,2288,0,4519,842,1019,2224,2722
73,1,6544,2518,5022,996,5036,1508,0,2134,0,4410,842,960,2178,2564
74,0,6799,2064,5551,816,5100,1699,0,2280,0,4519,842,1018,2219,2720
77,1,6543,2523,5021,1001,5036,1507,0,2134,0,4409,842,960,2177,2564
78,0,6769,2056,5523,810,5087,1682,0,2257,0,4512,842,1011,2213,2703
79,1,6531,2492,5028,989,5034,1497,0,2129,0,4402,842,959,2175,2555
80,0,6644,2034,5410,800,5058,1586,0,2185,0,4459,842,982,2211,2609
81,0,6644,2219,5310,885,5058,1586,0,2185,0,4459,842,982,2211,2609
84,0,6644,2223,5306,885,5058,1586,0,2185,0,4459,842,982,2211,2609
85,1,6424,2221,5085,882,5021,1403,0,2068,0,4356,842,950,2170,2462
86,0,6612,1840,5500,728,5047,1565,0,2161,0,4451,842,971,2211,2588
87,0,6612,2148,5316,852,5047,1565,0,2161,0,4451,842,971,2211,2588
88,0,6612,2146,5317,851,5047,1565,0,2161,0,4451,842,971,2211,2588
91,1,6381,2152,5085,856,5017,1364,0,2047,0,4334,842,946,2170,2423
92,0,6606,1735,5563,692,5047,1559,0,2157,0,4449,842,971,2211,2582
93,0,6606,2127,5320,841,5047,1559,0,2157,0,4449,842,971,2211,2582
94,0,6606,2129,5320,843,5047,1559,0,2157,0,4449,842,971,2211,2582
95,1,6369,2134,5085,850,5015,1354,0,2042,0,4327,842,944,2170,2413
98,0,6604,1726,5568,690,5047,1557,0,2156,0,4448,842,971,2211,2580
99,1,6369,2136,5083,850,5015,1354,0,2042,0,4327,842,944,2170,2413
100,0,6551,1723,5516,688,5034,1517,0,2131,0,4420,842,961,2191,2557
101,0,6552,2069,5301,818,5034,1518,0,2131,0,4421,842,961,2191,2558
102,0,6552,2072,5298,818,5034,1518,0,2131,0,4421,842,961,2191,2558
105,0,6552,2073,5298,819,5034,1518,0,2131,0,4421,842,961,2191,2558
106,0,6552,2068,5304,820,5034,1518,0,2131,0,4421,842,961,2191,2558
107,0,6552,2069,5300,817,5034,1518,0,2131,0,4421,842,961,2191,2558
108,0,6552,2072,5298,818,5034,1518,0,2131,0,4421,842,961,2191,2558
109,1,6343,2075,5089,821,5009,1334,0,2029,0,4314,842,940,2165,2396
112,0,6551,1659,5557,665,5034,1517,0,2131,0,4420,842,961,2191,2557
113,1,6342,2070,5095,823,5009,1333,0,2028,0,4314,842,940,2165,2395
114,0,6534,1657,5541,664,5031,1503,0,2120,0,4414,842,960,2189,2543
115,1,6330,2070,5076,816,5006,1324,0,2021,0,4309,842,937,2165,2386
116,0,6465,1648,5477,660,5026,1439,0,2089,0,4376,842,955,2181,2487
119,0,6466,1974,5269,777,5026,1440,0,2089,0,4377,842,955,2181,2488
120,1,6276,1976,5079,779,5000,1276,0,1989,0,4287,842,933,2159,2342
121,1,6236,1581,5304,649,4995,1241,0,1965,0,4271,842,930,2158,2306
122,0,6358,1564,5432,638,5012,1346,0,2035,0,4323,842,943,2169,2404
123,1,6137,1715,5116,694,4984,1153,0,1918,0,4219,842,923,2141,2231
126,0,6340,1420,5511,591,5007,1333,0,2024,0,4316,842,938,2168,2392
127,0,6340,1661,5349,670,5007,1333,0,2024,0,4316,842,938,2168,2392
128,0,6340,1656,5352,668,5007,1333,0,2024,0,4316,842,938,2168,2392
129,0,6340,1665,5345,670,5007,1333,0,2024,0,4316,842,938,2168,2392
130,0,6340,1664,5345,669,5007,1333,0,2024,0,4316,842,938,2168,2392
133,0,6340,1657,5350,667,5007,1333,0,2024,0,4316,842,938,2168,2392
134,0,6340,1659,5352,671,5007,1333,0,2024,0,4316,842,938,2168,2392
135,0,6340,1660,5349,669,5007,1333,0,2024,0,4316,842,938,2168,2392
136,1,6120,1663,5129,672,4984,1136,0,1909,0,4211,842,923,2140,2215
137,0,6340,1404,5523,587,5007,1333,0,2024,0,4316,842,938,2168,2392
140,1,6120,1658,5134,672,4984,1136,0,1909,0,4211,842,923,2140,2215
141,0,6331,1401,5519,589,5004,1327,0,2017,0,4314,842,937,2167,2385
142,1,6118,1654,5135,671,4984,1134,0,1909,0,4209,842,923,2140,2213
143,0,6292,1399,5477,584,4997,1295,0,1995,0,4297,842,935,2164,2351
144,1,6101,1630,5134,663,4978,1123,0,1898,0,4203,842,921,2136,2202
147,0,6239,1392,5435,588,4991,1248,0,1964,0,4275,842,930,2159,2308
148,1,6068,1569,5143,644,4975,1093,0,1882,0,4186,842,918,2134,2174
149,1,6045,1360,5266,581,4973,1072,0,1871,0,4174,842,917,2134,2152
150,0,6121,1351,5344,574,4981,1140,0,1907,0,4214,842,923,2142,2214
151,0,6121,1416,5302,597,4981,1140,0,1907,0,4214,842,923,2142,2214
154,0,6121,1410,5304,593,4981,1140,0,1907,0,4214,842,923,2142,2214
155,1,5970,1410,5153,593,4955,1015,0,1830,0,4140,842,910,2123,2095
156,0,6121,1289,5385,553,4981,1140,0,1907,0,4214,842,923,2142,2214
157,0,6121,1416,5302,597,4981,1140,0,1907,0,4214,842,923,2142,2214
158,0,6121,1414,5301,594,4981,1140,0,1907,0,4214,842,923,2142,2214
161,0,6121,1411,5302,592,4981,1140,0,1907,0,4214,842,923,2142,2214
162,0,6121,1412,5302,593,4981,1140,0,1907,0,4214,842,923,2142,2214
163,0,6121,1409,5304,592,4981,1140,0,1907,0,4214,842,923,2142,2214
164,1,5970,1406,5154,590,4955,1015,0,1830,0,4140,842,910,2123,2095
165,0,6120,1292,5385,557,4980,1140,0,1906,0,4214,842,923,2142,2213
168,0,6120,1406,5305,591,4980,1140,0,1906,0,4214,842,923,2142,2213
169,1,5970,1413,5151,594,4955,1015,0,1830,0,4140,842,910,2123,2095
170,0,6115,1292,5379,556,4976,1139,0,1904,0,4211,842,921,2141,2211
171,1,5970,1404,5155,589,4955,1015,0,1830,0,4140,842,910,2123,2095
172,0,6092,1291,5356,555,4968,1124,0,1889,0,4203,842,917,2140,2193
175,0,6094,1394,5287,587,4968,1126,0,1890,0,4204,842,917,2140,2195
176,0,6094,1394,5287,587,4968,1126,0,1890,0,4204,842,917,2140,2195
177,0,6094,1392,5286,584,4968,1126,0,1890,0,4204,842,917,2140,2195
178,1,5960,1394,5153,587,4955,1005,0,1825,0,4135,842,910,2123,2085
179,0,6090,1282,5361,553,4967,1123,0,1887,0,4203,842,917,2139,2192
182,0,6090,1396,5283,589,4967,1123,0,1887,0,4203,842,917,2139,2192
183,0,6090,1391,5281,582,4967,1123,0,1887,0,4203,842,917,2139,2192
184,0,6090,1393,5281,584,4967,1123,0,1887,0,4203,842,917,2139,2192
185,0,6090,1395,5282,587,4967,1123,0,1887,0,4203,842,917,2139,2192
186,0,6090,1396,5286,592,4967,1123,0,1887,0,4203,842,917,2139,2192
189,0,6090,1396,5282,588,4967,1123,0,1887,0,4203,842,917,2139,2192
190,1,5959,1393,5154,588,4954,1005,0,1824,0,4135,842,910,2122,2085
191,0,6090,1273,5366,549,4967,1123,0,1887,0,4203,842,917,2139,2192
192,0,6090,1394,5282,586,4967,1123,0,1887,0,4203,842,917,2139,2192
193,0,6090,1393,5282,585,4967,1123,0,1887,0,4203,842,917,2139,2192
196,0,6090,1399,5279,588,4967,1123,0,1887,0,4203,842,917,2139,2192
197,0,6090,1393,5282,585,4967,1123,0,1887,0,4203,842,917,2139,2192
198,0,6090,1391,5284,585,4967,1123,0,1887,0,4203,842,917,2139,2192
199,0,6090,1393,5282,585,4967,1123,0,1887,0,4203,842,917,2139,2192
200,1,5959,1396,5152,589,4954,1005,0,1824,0,4135,842,910,2122,2085
203,1,5949,1275,5223,549,4953,996,0,1818,0,4131,842,909,2122,2076
204,0,6078,1277,5353,552,4962,1116,0,1879,0,4199,842,917,2134,2185
205,1,5947,1383,5148,584,4952,995,0,1815,0,4132,842,909,2121,2075
206,0,6027,1276,5303,552,4957,1070,0,1855,0,4172,842,912,2133,2140
207,0,6027,1344,5258,575,4957,1070,0,1855,0,4172,842,912,2133,2140
210,0,6027,1341,5261,575,4957,1070,0,1855,0,4172,842,912,2133,2140
211,0,6027,1338,5262,573,4957,1070,0,1855,0,4172,842,912,2133,2140
212,0,6027,1334,5266,573,4957,1070,0,1855,0,4172,842,912,2133,2140
213,0,6027,1345,5259,577,4957,1070,0,1855,0,4172,842,912,2133,2140
214,1,5910,1347,5141,578,4949,961,0,1795,0,4115,842,907,2119,2042
217,1,5906,1228,5216,538,4949,957,0,1794,0,4112,842,907,2119,2038
218,0,5988,1223,5300,535,4955,1033,0,1838,0,4150,842,911,2130,2105
219,0,5988,1300,5246,558,4955,1033,0,1838,0,4150,842,911,2130,2105
220,0,5988,1295,5249,556,4955,1033,0,1838,0,4150,842,911,2130,2105
221,0,5988,1304,5243,559,4955,1033,0,1838,0,4150,842,911,2130,2105
224,0,5988,1299,5246,557,4955,1033,0,1838,0,4150,842,911,2130,2105
225,0,5988,1294,5249,555,4955,1033,0,1838,0,4150,842,911,2130,2105
226,0,5988,1296,5247,555,4955,1033,0,1838,0,4150,842,911,2130,2105
227,0,5988,1295,5246,553,4955,1033,0,1838,0,4150,842,911,2130,2105
228,0,5988,1294,5246,552,4955,1033,0,1838,0,4150,842,911,2130,2105
231,1,5884,1296,5141,553,4946,938,0,1781,0,4103,842,906,2114,2022
232,0,5988,1218,5301,531,4955,1033,0,1838,0,4150,842,911,2130,2105
233,0,5988,1299,5244,555,4955,1033,0,1838,0,4150,842,911,2130,2105
234,0,5988,1297,5249,558,4955,1033,0,1838,0,4150,842,911,2130,2105
235,0,5988,1299,5246,557,4955,1033,0,1838,0,4150,842,911,2130,2105
238,0,5988,1295,5246,553,4955,1033,0,1838,0,4150,842,911,2130,2105
239,0,5988,1301,5246,559,4955,1033,0,1838,0,4150,842,911,2130,2105
240,0,5988,1303,5244,559,4955,1033,0,1838,0,4150,842,911,2130,2105
241,0,5988,1301,5246,559,4955,1033,0,1838,0,4150,842,911,2130,2105
242,0,5988,1300,5245,557,4955,1033,0,1838,0,4150,842,911,2130,2105
245,0,5988,1303,5244,559,4955,1033,0,1838,0,4150,842,911,2130,2105
246,1,5884,1295,5142,553,4946,938,0,1781,0,4103,842,906,2114,2022
247,1,5883,1216,5196,529,4945,938,0,1781,0,4102,842,905,2114,2022
248,1,5883,1212,5199,528,4945,938,0,1781,0,4102,842,905,2114,2022
249,0,5968,1212,5282,526,4950,1018,0,1827,0,4141,842,910,2127,2089
252,0,5969,1289,5233,553,4950,1019,0,1827,0,4142,842,910,2127,2090
253,0,5969,1286,5232,549,4950,1019,0,1827,0,4142,842,910,2127,2090
254,0,5969,1288,5234,553,4950,1019,0,1827,0,4142,842,910,2127,2090
255,1,5879,1286,5143,550,4944,935,0,1778,0,4101,842,905,2113,2019
256,0,5968,1208,5287,527,4950,1018,0,1827,0,4141,842,910,2127,2089
259,0,5968,1293,5226,551,4950,1018,0,1827,0,4141,842,910,2127,2089
260,1,5878,1295,5138,555,4943,935,0,1777,0,4101,842,905,2113,2018
261,1,5875,1210,5196,531,4942,933,0,1774,0,4101,842,905,2113,2015
262,1,5875,1214,5190,529,4942,933,0,1774,0,4101,842,905,2113,2015
263,0,5880,1209,5201,530,4943,937,0,1779,0,4101,842,905,2113,2020
266,1,5832,1221,5144,533,4933,899,0,1749,0,4083,842,902,2106,1982
267,0,5878,1192,5207,521,4942,936,0,1777,0,4101,842,905,2113,2018
268,1,5832,1213,5149,530,4933,899,0,1749,0,4083,842,902,2106,1982
269,0,5877,1182,5214,519,4942,935,0,1776,0,4101,842,905,2113,2017
270,0,5877,1211,5195,529,4942,935,0,1776,0,4101,842,905,2113,2017
273,0,5877,1214,5192,529,4942,935,0,1776,0,4101,842,905,2113,2017
274,0,5877,1211,5190,524,4942,935,0,1776,0,4101,842,905,2113,2017
275,0,5877,1211,5192,526,4942,935,0,1776,0,4101,842,905,2113,2017
276,1,5829,1215,5144,530,4931,898,0,1747,0,4082,842,901,2105,1981
277,0,5876,1185,5208,517,4941,935,0,1775,0,4101,842,905,2113,2016
280,1,5829,1214,5146,531,4931,898,0,1747,0,4082,842,901,2105,1981
281,0,5871,1185,5204,518,4938,933,0,1770,0,4101,842,905,2112,2012
282,0,5871,1210,5192,531,4938,933,0,1770,0,4101,842,905,2112,2012
283,1,5829,1212,5149,532,4931,898,0,1747,0,4082,842,901,2105,1981
284,0,5869,1189,5200,520,4936,933,0,1768,0,4101,842,905,2110,2012
287,0,5869,1213,5183,527,4936,933,0,1768,0,4101,842,905,2110,2012
288,0,5869,1207,5189,527,4936,933,0,1768,0,4101,842,905,2110,2012
289,0,5869,1210,5188,529,4936,933,0,1768,0,4101,842,905,2110,2012
290,0,5869,1210,5189,530,4936,933,0,1768,0,4101,842,905,2110,2012
291,0,5869,1211,5188,530,4936,933,0,1768,0,4101,842,905,2110,2012
294,0,5869,1212,5184,527,4936,933,0,1768,0,4101,842,905,2110,2012
295,1,5828,1210,5146,528,4931,897,0,1747,0,4081,842,901,2104,1981
296,0,5869,1183,5205,519,4936,933,0,1768,0,4101,842,905,2110,2012
297,1,5828,1212,5145,529,4931,897,0,1747,0,4081,842,901,2104,1981
298,0,5869,1184,5202,517,4936,933,0,1768,0,4101,842,905,2110,2012
301,0,5869,1208,5187,526,4936,933,0,1768,0,4101,842,905,2110,2012
302,1,5828,1206,5148,526,4931,897,0,1747,0,4081,842,901,2104,1981
303,0,5865,1188,5197,520,4935,930,0,1765,0,4100,842,905,2109,2009
304,0,5865,1206,5185,526,4935,930,0,1765,0,4100,842,905,2109,2009
305,1,5827,1207,5149,529,4931,896,0,1746,0,4081,842,901,2104,1980
308,0,5847,1184,5181,518,4933,914,0,1757,0,4090,842,903,2109,1993
309,1,5816,1199,5145,528,4929,887,0,1739,0,4077,842,901,2103,1970
310,0,5831,1169,5177,515,4931,900,0,1747,0,4084,842,901,2107,1981
311,0,5831,1184,5165,518,4931,900,0,1747,0,4084,842,901,2107,1981
312,0,5831,1188,5164,521,4931,900,0,1747,0,4084,842,901,2107,1981
315,0,5831,1183,5166,518,4931,900,0,1747,0,4084,842,901,2107,1981
316,1,5804,1179,5141,516,4927,877,0,1730,0,4074,842,901,2102,1959
317,1,5804,1169,5151,516,4927,877,0,1730,0,4074,842,901,2102,1959
318,0,5828,1168,5174,514,4930,898,0,1746,0,4082,842,901,2105,1980
319,1,5803,1182,5138,517,4926,877,0,1729,0,4074,842,901,2101,1959
322,1,5803,1168,5151,516,4926,877,0,1729,0,4074,842,901,2101,1959
323,0,5817,1171,5161,515,4927,890,0,1737,0,4080,842,901,2102,1972
324,0,5817,1182,5153,518,4927,890,0,1737,0,4080,842,901,2102,1972
325,0,5817,1174,5155,512,4927,890,0,1737,0,4080,842,901,2102,1972
326,0,5817,1176,5155,514,4927,890,0,1737,0,4080,842,901,2102,1972
329,1,5801,1182,5137,518,4925,876,0,1728,0,4073,842,901,2100,1958
330,1,5801,1164,5148,511,4925,876,0,1728,0,4073,842,901,2100,1958
331,0,5805,1167,5152,514,4927,878,0,1731,0,4074,842,901,2102,1960
332,1,5796,1168,5142,514,4925,871,0,1728,0,4068,842,901,2099,1954
333,0,5803,1166,5149,512,4926,877,0,1729,0,4074,842,901,2101,1959
336,1,5792,1169,5138,515,4924,868,0,1725,0,4067,842,901,2098,1951
337,0,5802,1163,5151,512,4925,877,0,1728,0,4074,842,901,2100,1959
338,1,5791,1172,5137,518,4924,867,0,1725,0,4066,842,901,2097,1951
339,0,5802,1163,5153,514,4925,877,0,1728,0,4074,842,901,2100,1959
340,1,5791,1168,5137,514,4924,867,0,1725,0,4066,842,901,2097,1951
343,0,5801,1165,5152,516,4925,876,0,1728,0,4073,842,901,2100,1958
344,0,5801,1167,5150,516,4925,876,0,1728,0,4073,842,901,2100,1958
345,1,5791,1167,5138,514,4924,867,0,1725,0,4066,842,901,2097,1951
346,1,5790,1162,5142,514,4923,867,0,1724,0,4066,842,900,2097,1951
347,1,5790,1158,5145,513,4923,867,0,1724,0,4066,842,900,2097,1951
350,0,5792,1161,5141,510,4924,868,0,1725,0,4067,842,901,2098,1951
351,0,5792,1170,5142,520,4924,868,0,1725,0,4067,842,901,2098,1951
352,1,5785,1165,5133,513,4921,864,0,1721,0,4064,842,899,2097,1947
353,0,5792,1156,5147,511,4924,868,0,1725,0,4067,842,901,2098,1951
354,1,5785,1164,5134,513,4921,864,0,1721,0,4064,842,899,2097,1947
357,0,5792,1161,5143,512,4924,868,0,1725,0,4067,842,901,2098,1951
358,0,5792,1164,5140,512,4924,868,0,1725,0,4067,842,901,2098,1951
359,1,5785,1167,5130,512,4921,864,0,1721,0,4064,842,899,2097,1947
360,1,5785,1163,5133,511,4921,864,0,1721,0,4064,842,899,2097,1947
361,0,5789,1165,5139,515,4922,867,0,1723,0,4066,842,900,2097,1950
364,0,5789,1165,5138,514,4922,867,0,1723,0,4066,842,900,2097,1950
