Day,Rain,ActiveMode,ActiveNorm,ActiveModeCounterToInactiveNorm,InactiveModeCounterToActiveNorm,LocalCommute,CityCommute,DistantCommute,Subculture A,Subculture B,Subculture C,0,1,2,3
0,0,9108,9108,0,0,4935,4173,0,2456,0,6652,1693,2427,1668,3320
1,1,5948,5694,3375,3121,4558,1390,0,2042,0,3906,809,1333,767,3039
2,0,8154,1621,7067,534,4928,3226,0,2451,0,5703,1573,2372,890,3319
3,0,8220,4478,5462,1720,4931,3289,0,2455,0,5765,1610,2399,891,3320
4,0,8220,4572,5411,1763,4931,3289,0,2455,0,5765,1610,2399,891,3320
7,0,8220,4577,5405,1762,4931,3289,0,2455,0,5765,1610,2399,891,3320
8,0,8220,4575,5410,1765,4931,3289,0,2455,0,5765,1610,2399,891,3320
9,1,5797,4579,3614,2396,4408,1389,0,2031,0,3766,809,1322,628,3038
10,0,7836,1556,6798,518,4898,2938,0,2436,0,5400,1398,2270,853,3315
11,0,7921,4020,5414,1513,4908,3013,0,2445,0,5476,1426,2325,854,3316
14,0,7921,4150,5349,1578,4908,3013,0,2445,0,5476,1426,2325,854,3316
15,0,7921,4158,5343,1580,4908,3013,0,2445,0,5476,1426,2325,854,3316
16,0,7921,4149,5351,1579,4908,3013,0,2445,0,5476,1426,2325,854,3316
17,1,5767,4153,3740,2126,4382,1385,0,2012,0,3755,809,1306,618,3034
18,0,7531,1530,6512,511,4859,2672,0,2421,0,5110,1250,2145,826,3310
21,1,5695,3585,3851,1741,4333,1362,0,1962,0,3733,809,1268,607,3011
22,0,6863,1456,5914,507,4710,2153,0,2315,0,4548,1008,1808,765,3282
23,0,6898,2537,5310,949,4718,2180,0,2324,0,4574,1015,1833,765,3285
24,1,5520,2573,4138,1191,4208,1312,0,1829,0,3691,808,1165,586,2961
25,1,5358,1270,4635,547,4103,1255,0,1701,0,3657,808,1064,582,2904
28,0,5820,1116,5175,471,4379,1441,0,2024,0,3796,818,1324,618,3060
29,0,5829,1564,4935,670,4383,1446,0,2028,0,3801,818,1333,618,3060
30,1,5145,1568,4270,693,3982,1163,0,1566,0,3579,808,980,545,2812
31,0,5736,929,5201,394,4338,1398,0,1979,0,3757,813,1279,611,3033
32,0,5746,1488,4900,642,4342,1404,0,1984,0,3762,813,1286,611,3036
35,0,5746,1497,4893,644,4342,1404,0,1984,0,3762,813,1286,611,3036
36,0,5746,1500,4893,647,4342,1404,0,1984,0,3762,813,1286,611,3036
37,0,5746,1495,4900,649,4342,1404,0,1984,0,3762,813,1286,611,3036
38,0,5746,1503,4893,650,4342,1404,0,1984,0,3762,813,1286,611,3036
39,1,5124,1492,4286,654,3971,1153,0,1549,0,3575,808,970,544,2802
42,0,5732,915,5208,391,4335,1397,0,1976,0,3756,813,1276,611,3032
43,0,5737,1484,4891,638,4336,1401,0,1978,0,3759,813,1279,611,3034
44,0,5737,1489,4889,641,4336,1401,0,1978,0,3759,813,1279,611,3034
45,1,5123,1493,4282,652,3970,1153,0,1548,0,3575,808,969,544,2802
46,0,5691,906,5173,388,4303,1388,0,1943,0,3748,813,1249,606,3023
49,1,5113,1450,4295,632,3962,1151,0,1539,0,3574,808,962,543,2800
50,0,5510,900,4996,386,4173,1337,0,1810,0,3700,812,1142,583,2973
51,1,5031,1267,4305,541,3920,1111,0,1490,0,3541,808,934,529,2760
52,1,4960,845,4488,373,3896,1064,0,1452,0,3508,808,918,523,2711
53,1,4953,812,4503,362,3895,1058,0,1448,0,3505,808,917,523,2705
56,1,4951,800,4504,353,3895,1056,0,1448,0,3503,808,917,523,2703
57,1,4951,807,4500,356,3895,1056,0,1448,0,3503,808,917,523,2703
58,1,4951,801,4504,354,3895,1056,0,1448,0,3503,808,917,523,2703
59,1,4951,802,4506,357,3895,1056,0,1448,0,3503,808,917,523,2703
60,0,4953,800,4509,356,3895,1058,0,1448,0,3505,808,917,523,2705
63,1,4736,797,4292,353,3835,901,0,1338,0,3398,808,878,504,2546
64,0,4951,641,4609,299,3895,1056,0,1448,0,3503,808,917,523,2703
65,1,4736,804,4288,356,3835,901,0,1338,0,3398,808,878,504,2546
66,0,4951,635,4613,297,3895,1056,0,1448,0,3503,808,917,523,2703
67,0,4951,795,4509,353,3895,1056,0,1448,0,3503,808,917,523,2703
70,1,4736,801,4290,355,3835,901,0,1338,0,3398,808,878,504,2546
71,0,4950,637,4609,296,3894,1056,0,1448,0,3502,808,916,523,2703
72,0,4950,806,4500,356,3894,1056,0,1448,0,3502,808,916,523,2703
73,1,4736,800,4291,355,3835,901,0,1338,0,3398,808,878,504,2546
74,0,4944,634,4607,297,3890,1054,0,1443,0,3501,808,914,523,2699
77,1,4733,799,4291,357,3835,898,0,1336,0,3397,808,878,504,2543
78,0,4897,636,4559,298,3861,1036,0,1422,0,3475,808,903,505,2681
79,1,4721,784,4289,352,3831,890,0,1328,0,3393,808,877,502,2534
80,0,4781,629,4448,296,3843,938,0,1365,0,3416,808,886,504,2583
81,0,4781,653,4434,306,3843,938,0,1365,0,3416,808,886,504,2583
84,0,4781,655,4431,305,3843,938,0,1365,0,3416,808,886,504,2583
85,1,4623,658,4270,305,3822,801,0,1273,0,3350,808,870,502,2443
86,0,4767,541,4488,262,3841,926,0,1356,0,3411,808,884,504,2571
87,0,4767,651,4421,305,3841,926,0,1356,0,3411,808,884,504,2571
88,0,4767,649,4423,305,3841,926,0,1356,0,3411,808,884,504,2571
91,1,4612,648,4270,306,3822,790,0,1268,0,3344,808,870,502,2432
92,0,4764,535,4489,260,3840,924,0,1355,0,3409,808,883,504,2569
93,0,4764,650,4420,306,3840,924,0,1355,0,3409,808,883,504,2569
94,0,4764,650,4418,304,3840,924,0,1355,0,3409,808,883,504,2569
95,1,4611,645,4271,305,3822,789,0,1267,0,3344,808,870,502,2431
98,0,4759,537,4481,259,3839,920,0,1350,0,3409,808,883,504,2564
99,1,4608,648,4265,305,3821,787,0,1265,0,3343,808,869,502,2429
100,0,4727,532,4454,259,3829,898,0,1331,0,3396,808,877,502,2540
101,0,4728,630,4394,296,3829,899,0,1332,0,3396,808,877,502,2541
102,0,4728,634,4392,298,3829,899,0,1332,0,3396,808,877,502,2541
105,0,4728,636,4391,299,3829,899,0,1332,0,3396,808,877,502,2541
106,0,4728,634,4390,296,3829,899,0,1332,0,3396,808,877,502,2541
107,0,4728,632,4392,296,3829,899,0,1332,0,3396,808,877,502,2541
108,0,4728,637,4391,300,3829,899,0,1332,0,3396,808,877,502,2541
109,1,4584,635,4249,300,3819,765,0,1253,0,3331,808,869,501,2406
112,0,4727,520,4460,253,3829,898,0,1331,0,3396,808,877,502,2540
113,1,4584,633,4251,300,3819,765,0,1253,0,3331,808,869,501,2406
114,0,4725,521,4458,254,3828,897,0,1330,0,3395,808,876,502,2539
115,1,4584,635,4248,299,3819,765,0,1253,0,3331,808,869,501,2406
116,0,4676,516,4412,252,3826,850,0,1303,0,3373,808,874,502,2492
119,0,4676,585,4370,279,3826,850,0,1303,0,3373,808,874,502,2492
120,1,4544,581,4241,278,3817,727,0,1235,0,3309,808,867,501,2368
121,1,4519,495,4266,242,3815,704,0,1224,0,3295,808,866,501,2344
122,0,4596,494,4345,243,3819,777,0,1259,0,3337,808,869,501,2418
123,1,4458,529,4184,255,3809,649,0,1194,0,3264,808,860,501,2289
126,0,4583,455,4356,228,3819,764,0,1253,0,3330,808,869,501,2405
127,0,4584,519,4319,254,3819,765,0,1253,0,3331,808,869,501,2406
128,0,4584,518,4319,253,3819,765,0,1253,0,3331,808,869,501,2406
129,0,4584,520,4320,256,3819,765,0,1253,0,3331,808,869,501,2406
130,0,4584,518,4318,252,3819,765,0,1253,0,3331,808,869,501,2406
133,0,4584,516,4320,252,3819,765,0,1253,0,3331,808,869,501,2406
134,0,4584,516,4322,254,3819,765,0,1253,0,3331,808,869,501,2406
135,0,4584,521,4319,256,3819,765,0,1253,0,3331,808,869,501,2406
136,1,4445,516,4182,253,3807,638,0,1186,0,3259,808,858,501,2278
137,0,4583,451,4358,226,3819,764,0,1253,0,3330,808,869,501,2405
140,1,4444,523,4177,256,3807,637,0,1185,0,3259,808,858,501,2277
141,0,4576,448,4351,223,3818,758,0,1248,0,3328,808,869,501,2398
142,1,4440,516,4175,251,3807,633,0,1184,0,3256,808,858,501,2273
143,0,4559,445,4338,224,3817,742,0,1241,0,3318,808,868,501,2382
144,1,4434,513,4173,252,3807,627,0,1182,0,3252,808,858,501,2267
147,0,4515,444,4294,223,3812,703,0,1219,0,3296,808,863,501,2343
148,1,4402,492,4149,239,3802,600,0,1167,0,3235,808,857,501,2236
149,1,4379,431,4170,222,3798,581,0,1156,0,3223,808,854,501,2216
150,0,4444,422,4240,218,3807,637,0,1185,0,3259,808,858,501,2277
151,0,4444,452,4220,228,3807,637,0,1185,0,3259,808,858,501,2277
154,0,4444,453,4216,225,3807,637,0,1185,0,3259,808,858,501,2277
155,1,4326,451,4100,225,3793,533,0,1129,0,3197,808,851,501,2166
156,0,4443,404,4249,210,3807,636,0,1185,0,3258,808,858,501,2276
157,0,4444,449,4220,225,3807,637,0,1185,0,3259,808,858,501,2277
158,0,4444,449,4219,224,3807,637,0,1185,0,3259,808,858,501,2277
161,0,4444,452,4216,224,3807,637,0,1185,0,3259,808,858,501,2277
162,0,4444,449,4218,223,3807,637,0,1185,0,3259,808,858,501,2277
163,0,4444,450,4217,223,3807,637,0,1185,0,3259,808,858,501,2277
164,1,4326,454,4098,226,3793,533,0,1129,0,3197,808,851,501,2166
165,0,4441,402,4248,209,3805,636,0,1183,0,3258,808,858,501,2274
168,0,4442,449,4216,223,3805,637,0,1183,0,3259,808,858,501,2275
169,1,4326,451,4102,227,3793,533,0,1129,0,3197,808,851,501,2166
170,0,4436,405,4240,209,3801,635,0,1179,0,3257,808,858,501,2269
171,1,4323,451,4100,228,3792,531,0,1127,0,3196,808,850,501,2164
172,0,4420,407,4224,211,3799,621,0,1175,0,3245,808,857,501,2254
175,0,4422,440,4205,223,3799,623,0,1175,0,3247,808,857,501,2256
176,0,4422,442,4203,223,3799,623,0,1175,0,3247,808,857,501,2256
177,0,4422,442,4205,225,3799,623,0,1175,0,3247,808,857,501,2256
178,1,4318,438,4102,222,3791,527,0,1123,0,3195,808,850,501,2159
179,0,4417,406,4222,211,3799,618,0,1174,0,3243,808,857,501,2251
182,0,4418,443,4198,223,3799,619,0,1174,0,3244,808,857,501,2252
183,0,4418,439,4201,222,3799,619,0,1174,0,3244,808,857,501,2252
184,0,4418,442,4199,223,3799,619,0,1174,0,3244,808,857,501,2252
185,0,4418,442,4200,224,3799,619,0,1174,0,3244,808,857,501,2252
186,0,4418,440,4198,220,3799,619,0,1174,0,3244,808,857,501,2252
189,0,4418,437,4201,220,3799,619,0,1174,0,3244,808,857,501,2252
190,1,4317,437,4101,221,3791,526,0,1122,0,3195,808,850,501,2158
191,0,4417,401,4223,207,3799,618,0,1174,0,3243,808,857,501,2251
192,0,4417,444,4197,224,3799,618,0,1174,0,3243,808,857,501,2251
193,0,4417,438,4200,221,3799,618,0,1174,0,3243,808,857,501,2251
196,0,4417,440,4200,223,3799,618,0,1174,0,3243,808,857,501,2251
197,0,4417,440,4198,221,3799,618,0,1174,0,3243,808,857,501,2251
198,0,4417,436,4202,221,3799,618,0,1174,0,3243,808,857,501,2251
199,0,4417,441,4199,223,3799,618,0,1174,0,3243,808,857,501,2251
200,1,4316,440,4098,222,3791,525,0,1122,0,3194,808,850,501,2157
203,1,4306,403,4111,208,3788,518,0,1114,0,3192,808,847,501,2150
204,0,4410,397,4218,205,3798,612,0,1172,0,3238,808,857,501,2244
205,1,4302,439,4086,223,3786,516,0,1111,0,3191,808,845,501,2148
206,0,4350,398,4157,205,3793,557,0,1141,0,3209,808,852,501,2189
207,0,4350,417,4148,215,3793,557,0,1141,0,3209,808,852,501,2189
210,0,4350,418,4147,215,3793,557,0,1141,0,3209,808,852,501,2189
211,0,4350,417,4149,216,3793,557,0,1141,0,3209,808,852,501,2189
212,0,4350,417,4146,213,3793,557,0,1141,0,3209,808,852,501,2189
213,0,4350,416,4147,213,3793,557,0,1141,0,3209,808,852,501,2189
214,1,4260,415,4061,216,3779,481,0,1087,0,3173,808,841,501,2110
217,1,4255,388,4074,207,3778,477,0,1084,0,3171,808,840,501,2106
218,0,4323,385,4143,205,3791,532,0,1127,0,3196,808,850,501,2164
219,0,4323,408,4124,209,3791,532,0,1127,0,3196,808,850,501,2164
220,0,4323,403,4128,208,3791,532,0,1127,0,3196,808,850,501,2164
221,0,4323,405,4127,209,3791,532,0,1127,0,3196,808,850,501,2164
224,0,4323,406,4127,210,3791,532,0,1127,0,3196,808,850,501,2164
225,0,4323,405,4128,210,3791,532,0,1127,0,3196,808,850,501,2164
226,0,4323,408,4127,212,3791,532,0,1127,0,3196,808,850,501,2164
227,0,4323,407,4127,211,3791,532,0,1127,0,3196,808,850,501,2164
228,0,4323,404,4128,209,3791,532,0,1127,0,3196,808,850,501,2164
231,1,4230,406,4035,211,3777,453,0,1075,0,3155,808,840,501,2081
232,0,4323,380,4147,204,3791,532,0,1127,0,3196,808,850,501,2164
233,0,4323,406,4127,210,3791,532,0,1127,0,3196,808,850,501,2164
234,0,4323,403,4130,210,3791,532,0,1127,0,3196,808,850,501,2164
235,0,4323,404,4129,210,3791,532,0,1127,0,3196,808,850,501,2164
238,0,4323,406,4127,210,3791,532,0,1127,0,3196,808,850,501,2164
239,0,4323,405,4127,209,3791,532,0,1127,0,3196,808,850,501,2164
240,0,4323,405,4127,209,3791,532,0,1127,0,3196,808,850,501,2164
241,0,4323,403,4128,208,3791,532,0,1127,0,3196,808,850,501,2164
242,0,4323,407,4128,212,3791,532,0,1127,0,3196,808,850,501,2164
245,0,4323,407,4127,211,3791,532,0,1127,0,3196,808,850,501,2164
246,1,4230,404,4036,210,3777,453,0,1075,0,3155,808,840,501,2081
247,1,4226,379,4053,206,3776,450,0,1071,0,3155,808,839,501,2078
248,1,4226,381,4046,201,3776,450,0,1071,0,3155,808,839,501,2078
249,0,4299,379,4122,202,3782,517,0,1108,0,3191,808,845,501,2145
252,0,4299,399,4104,204,3782,517,0,1108,0,3191,808,845,501,2145
253,0,4299,402,4103,206,3782,517,0,1108,0,3191,808,845,501,2145
254,0,4299,398,4105,204,3782,517,0,1108,0,3191,808,845,501,2145
255,1,4217,400,4024,207,3776,441,0,1067,0,3150,808,839,501,2069
256,0,4299,382,4121,204,3782,517,0,1108,0,3191,808,845,501,2145
259,0,4299,397,4109,207,3782,517,0,1108,0,3191,808,845,501,2145
260,1,4217,400,4023,206,3776,441,0,1067,0,3150,808,839,501,2069
261,1,4217,380,4041,204,3776,441,0,1067,0,3150,808,839,501,2069
262,1,4217,377,4044,204,3776,441,0,1067,0,3150,808,839,501,2069
263,0,4226,378,4051,203,3776,450,0,1071,0,3155,808,839,501,2078
266,1,4186,382,4007,203,3772,414,0,1048,0,3138,808,836,501,2041
267,0,4220,375,4050,205,3776,444,0,1068,0,3152,808,839,501,2072
268,1,4186,383,4008,205,3772,414,0,1048,0,3138,808,836,501,2041
269,0,4217,373,4046,202,3776,441,0,1067,0,3150,808,839,501,2069
270,0,4217,378,4043,204,3776,441,0,1067,0,3150,808,839,501,2069
273,0,4217,381,4040,204,3776,441,0,1067,0,3150,808,839,501,2069
274,0,4217,381,4040,204,3776,441,0,1067,0,3150,808,839,501,2069
275,0,4217,379,4043,205,3776,441,0,1067,0,3150,808,839,501,2069
276,1,4185,380,4010,205,3772,413,0,1047,0,3138,808,836,501,2040
277,0,4217,376,4045,204,3776,441,0,1067,0,3150,808,839,501,2069
280,1,4185,379,4011,205,3772,413,0,1047,0,3138,808,836,501,2040
281,0,4216,376,4044,204,3775,441,0,1066,0,3150,808,839,501,2068
282,0,4216,379,4040,203,3775,441,0,1066,0,3150,808,839,501,2068
283,1,4185,378,4011,204,3772,413,0,1047,0,3138,808,836,501,2040
284,0,4216,372,4046,202,3775,441,0,1066,0,3150,808,839,501,2068
287,0,4216,376,4042,202,3775,441,0,1066,0,3150,808,839,501,2068
288,0,4216,379,4039,202,3775,441,0,1066,0,3150,808,839,501,2068
289,0,4216,377,4041,202,3775,441,0,1066,0,3150,808,839,501,2068
290,0,4216,380,4040,204,3775,441,0,1066,0,3150,808,839,501,2068
291,0,4216,378,4040,202,3775,441,0,1066,0,3150,808,839,501,2068
294,0,4216,380,4038,202,3775,441,0,1066,0,3150,808,839,501,2068
295,1,4185,374,4013,202,3772,413,0,1047,0,3138,808,836,501,2040
296,0,4216,373,4046,203,3775,441,0,1066,0,3150,808,839,501,2068
297,1,4185,380,4009,204,3772,413,0,1047,0,3138,808,836,501,2040
298,0,4216,377,4042,203,3775,441,0,1066,0,3150,808,839,501,2068
301,0,4216,378,4040,202,3775,441,0,1066,0,3150,808,839,501,2068
302,1,4185,380,4010,205,3772,413,0,1047,0,3138,808,836,501,2040
303,0,4210,375,4039,204,3773,437,0,1062,0,3148,808,837,501,2064
304,0,4210,381,4034,205,3773,437,0,1062,0,3148,808,837,501,2064
305,1,4184,378,4010,204,3772,412,0,1047,0,3137,808,836,501,2039
308,0,4193,372,4022,201,3773,420,0,1053,0,3140,808,837,501,2047
309,1,4175,375,4006,206,3772,403,0,1042,0,3133,808,836,501,2030
310,0,4185,375,4015,205,3772,413,0,1047,0,3138,808,836,501,2040
311,0,4185,374,4013,202,3772,413,0,1047,0,3138,808,836,501,2040
312,0,4185,373,4014,202,3772,413,0,1047,0,3138,808,836,501,2040
315,0,4185,375,4013,203,3772,413,0,1047,0,3138,808,836,501,2040
316,1,4169,376,3999,206,3771,398,0,1037,0,3132,808,835,501,2025
317,1,4169,371,4002,204,3771,398,0,1037,0,3132,808,835,501,2025
318,0,4185,372,4017,204,3772,413,0,1047,0,3138,808,836,501,2040
319,1,4169,378,3997,206,3771,398,0,1037,0,3132,808,835,501,2025
322,1,4169,374,4002,207,3771,398,0,1037,0,3132,808,835,501,2025
323,0,4180,370,4015,205,3771,409,0,1044,0,3136,808,835,501,2036
324,0,4180,378,4008,206,3771,409,0,1044,0,3136,808,835,501,2036
325,0,4180,377,4009,206,3771,409,0,1044,0,3136,808,835,501,2036
326,0,4180,375,4009,204,3771,409,0,1044,0,3136,808,835,501,2036
329,1,4167,377,3994,204,3771,396,0,1035,0,3132,808,835,501,2023
330,1,4167,372,4001,206,3771,396,0,1035,0,3132,808,835,501,2023
331,0,4170,373,4002,205,3771,399,0,1037,0,3133,808,835,501,2026
332,1,4159,372,3991,204,3770,389,0,1030,0,3129,808,834,501,2016
333,0,4169,369,4004,204,3771,398,0,1037,0,3132,808,835,501,2025
336,1,4159,370,3992,203,3770,389,0,1030,0,3129,808,834,501,2016
337,0,4169,372,4002,205,3771,398,0,1037,0,3132,808,835,501,2025
338,1,4159,369,3995,205,3770,389,0,1030,0,3129,808,834,501,2016
339,0,4169,372,4000,203,3771,398,0,1037,0,3132,808,835,501,2025
340,1,4159,370,3992,203,3770,389,0,1030,0,3129,808,834,501,2016
343,0,4167,369,4001,203,3771,396,0,1035,0,3132,808,835,501,2023
344,0,4167,370,4001,204,3771,396,0,1035,0,3132,808,835,501,2023
345,1,4158,370,3991,203,3770,388,0,1030,0,3128,808,834,501,2015
346,1,4158,371,3993,206,3770,388,0,1030,0,3128,808,834,501,2015
347,1,4158,372,3992,206,3770,388,0,1030,0,3128,808,834,501,2015
350,0,4159,374,3989,204,3770,389,0,1030,0,3129,808,834,501,2016
351,0,4159,372,3992,205,3770,389,0,1030,0,3129,808,834,501,2016
352,1,4155,369,3989,203,3770,385,0,1027,0,3128,808,834,501,2012
353,0,4159,370,3991,202,3770,389,0,1030,0,3129,808,834,501,2016
354,1,4155,374,3986,205,3770,385,0,1027,0,3128,808,834,501,2012
357,0,4159,374,3991,206,3770,389,0,1030,0,3129,808,834,501,2016
358,0,4159,370,3992,203,3770,389,0,1030,0,3129,808,834,501,2016
359,1,4155,375,3986,206,3770,385,0,1027,0,3128,808,834,501,2012
360,1,4154,369,3988,203,3770,384,0,1026,0,3128,808,834,501,2011
361,0,4158,370,3991,203,3770,388,0,1030,0,3128,808,834,501,2015
364,0,4158,373,3991,206,3770,388,0,1030,0,3128,808,834,501,2015
