Day,Rain,ActiveMode,ActiveNorm,ActiveModeCounterToInactiveNorm,InactiveModeCounterToActiveNorm,LocalCommute,CityCommute,DistantCommute,Subculture A,Subculture B,Subculture C,0,1,2,3
0,0,8994,8994,0,0,4882,4112,0,2409,0,6585,1586,2434,1694,3280
1,1,5965,5845,3274,3154,4537,1428,0,2055,0,3910,761,1429,755,3020
2,0,8054,1929,6750,625,4878,3176,0,2407,0,5647,1485,2395,894,3280
3,0,8101,4722,5188,1809,4878,3223,0,2407,0,5694,1509,2418,894,3280
4,0,8101,4795,5132,1826,4878,3223,0,2407,0,5694,1509,2418,894,3280
7,0,8101,4792,5137,1828,4878,3223,0,2407,0,5694,1509,2418,894,3280
8,0,8101,4792,5142,1833,4878,3223,0,2407,0,5694,1509,2418,894,3280
9,1,5809,4796,3478,2465,4382,1427,0,2053,0,3756,761,1426,602,3020
10,0,7796,1854,6541,599,4860,2936,0,2400,0,5396,1351,2309,857,3279
11,0,7871,4356,5163,1648,4866,3005,0,2404,0,5467,1384,2348,859,3280
14,0,7873,4482,5097,1706,4866,3007,0,2404,0,5469,1385,2349,859,3280
15,0,7873,4488,5090,1705,4866,3007,0,2404,0,5469,1385,2349,859,3280
16,0,7873,4495,5088,1710,4866,3007,0,2404,0,5469,1385,2349,859,3280
17,1,5780,4486,3556,2262,4358,1422,0,2045,0,3735,759,1418,586,3017
18,0,7512,1830,6278,596,4815,2697,0,2381,0,5131,1206,2213,821,3272
21,1,5711,3905,3692,1886,4305,1406,0,2008,0,3703,759,1387,564,3001
22,0,6881,1741,5709,569,4676,2205,0,2308,0,4573,964,1921,746,3250
23,0,6919,2958,5032,1071,4681,2238,0,2313,0,4606,970,1952,746,3251
24,1,5551,2993,3911,1353,4176,1375,0,1896,0,3655,758,1287,536,2970
25,1,5374,1566,4445,637,4067,1307,0,1767,0,3607,758,1192,524,2900
28,0,5854,1373,4995,514,4358,1496,0,2056,0,3798,769,1441,593,3051
29,0,5866,1878,4743,755,4363,1503,0,2061,0,3805,769,1452,593,3052
30,1,5171,1878,4084,791,3950,1221,0,1652,0,3519,757,1115,485,2814
31,0,5764,1170,5036,442,4314,1450,0,2020,0,3744,761,1409,571,3023
32,0,5767,1814,4694,741,4315,1452,0,2021,0,3746,762,1411,571,3023
35,0,5767,1819,4695,747,4315,1452,0,2021,0,3746,762,1411,571,3023
36,0,5767,1809,4698,740,4315,1452,0,2021,0,3746,762,1411,571,3023
37,0,5767,1818,4696,747,4315,1452,0,2021,0,3746,762,1411,571,3023
38,0,5767,1807,4699,739,4315,1452,0,2021,0,3746,762,1411,571,3023
39,1,5142,1820,4084,762,3932,1210,0,1631,0,3511,757,1103,479,2803
42,0,5755,1141,5042,428,4308,1447,0,2015,0,3740,761,1405,569,3020
43,0,5761,1805,4696,740,4310,1451,0,2018,0,3743,761,1408,569,3023
44,0,5761,1812,4691,742,4310,1451,0,2018,0,3743,761,1408,569,3023
45,1,5141,1810,4089,758,3931,1210,0,1630,0,3511,757,1102,479,2803
46,0,5705,1137,4994,426,4265,1440,0,1983,0,3722,760,1378,556,3011
49,1,5129,1765,4096,732,3925,1204,0,1625,0,3504,757,1099,476,2797
50,0,5561,1129,4852,420,4156,1405,0,1893,0,3668,760,1303,522,2976
51,1,5075,1583,4127,635,3902,1173,0,1588,0,3487,757,1083,469,2766
52,1,5031,1082,4362,413,3877,1154,0,1553,0,3478,757,1059,468,2747
53,1,5027,1049,4376,398,3876,1151,0,1550,0,3477,757,1058,468,2744
56,1,5027,1048,4378,399,3876,1151,0,1550,0,3477,757,1058,468,2744
57,1,5027,1044,4380,397,3876,1151,0,1550,0,3477,757,1058,468,2744
58,1,5027,1046,4378,397,3876,1151,0,1550,0,3477,757,1058,468,2744
59,1,5027,1058,4373,404,3876,1151,0,1550,0,3477,757,1058,468,2744
60,0,5027,1049,4374,396,3876,1151,0,1550,0,3477,757,1058,468,2744
63,1,4830,1051,4184,405,3797,1033,0,1426,0,3404,757,993,455,2625
64,0,5027,843,4515,331,3876,1151,0,1550,0,3477,757,1058,468,2744
65,1,4830,1049,4182,401,3797,1033,0,1426,0,3404,757,993,455,2625
66,0,5027,844,4516,333,3876,1151,0,1550,0,3477,757,1058,468,2744
67,0,5027,1050,4375,398,3876,1151,0,1550,0,3477,757,1058,468,2744
70,1,4830,1052,4182,404,3797,1033,0,1426,0,3404,757,993,455,2625
71,0,5026,845,4512,331,3876,1150,0,1550,0,3476,757,1058,468,2743
72,0,5027,1055,4375,403,3876,1151,0,1550,0,3477,757,1058,468,2744
73,1,4830,1051,4180,401,3797,1033,0,1426,0,3404,757,993,455,2625
74,0,5024,841,4511,328,3874,1150,0,1548,0,3476,757,1057,468,2742
77,1,4828,1050,4180,402,3795,1033,0,1424,0,3404,757,991,455,2625
78,0,4987,844,4474,331,3847,1140,0,1530,0,3457,757,1043,455,2732
79,1,4819,1023,4188,392,3789,1030,0,1420,0,3399,757,989,451,2622
80,0,4872,836,4362,326,3810,1062,0,1450,0,3422,757,1006,455,2654
81,0,4872,885,4333,346,3810,1062,0,1450,0,3422,757,1006,455,2654
84,0,4872,883,4333,344,3810,1062,0,1450,0,3422,757,1006,455,2654
85,1,4730,882,4198,350,3773,957,0,1372,0,3358,757,975,451,2547
86,0,4866,747,4423,304,3809,1057,0,1448,0,3418,757,1005,455,2649
87,0,4866,881,4329,344,3809,1057,0,1448,0,3418,757,1005,455,2649
88,0,4866,872,4332,338,3809,1057,0,1448,0,3418,757,1005,455,2649
91,1,4721,878,4190,347,3769,952,0,1366,0,3355,757,971,451,2542
92,0,4865,731,4426,292,3809,1056,0,1448,0,3417,757,1005,455,2648
93,0,4865,878,4327,340,3809,1056,0,1448,0,3417,757,1005,455,2648
94,0,4865,880,4326,341,3809,1056,0,1448,0,3417,757,1005,455,2648
95,1,4718,877,4186,345,3768,950,0,1364,0,3354,757,971,451,2539
98,0,4861,727,4425,291,3808,1053,0,1445,0,3416,757,1004,455,2645
99,1,4717,878,4184,345,3768,949,0,1363,0,3354,757,971,451,2538
100,0,4825,728,4385,288,3793,1032,0,1423,0,3402,757,992,454,2622
101,0,4825,841,4314,330,3793,1032,0,1423,0,3402,757,992,454,2622
102,0,4825,838,4316,329,3793,1032,0,1423,0,3402,757,992,454,2622
105,0,4825,842,4313,330,3793,1032,0,1423,0,3402,757,992,454,2622
106,0,4825,841,4314,330,3793,1032,0,1423,0,3402,757,992,454,2622
107,0,4825,839,4314,328,3793,1032,0,1423,0,3402,757,992,454,2622
108,0,4825,836,4316,327,3793,1032,0,1423,0,3402,757,992,454,2622
109,1,4697,836,4193,332,3764,933,0,1353,0,3344,757,967,451,2522
112,0,4825,698,4412,285,3793,1032,0,1423,0,3402,757,992,454,2622
113,1,4697,841,4189,333,3764,933,0,1353,0,3344,757,967,451,2522
114,0,4814,691,4404,281,3786,1028,0,1419,0,3395,757,989,451,2617
115,1,4693,835,4190,332,3762,931,0,1351,0,3342,757,967,449,2520
116,0,4764,692,4357,285,3774,990,0,1391,0,3373,757,977,451,2579
119,0,4764,798,4287,321,3774,990,0,1391,0,3373,757,977,451,2579
120,1,4657,793,4183,319,3760,897,0,1337,0,3320,757,965,449,2486
121,1,4629,662,4242,275,3758,871,0,1319,0,3310,757,964,449,2459
122,0,4707,655,4324,272,3765,942,0,1358,0,3349,757,968,451,2531
123,1,4591,726,4157,292,3756,835,0,1298,0,3293,757,962,449,2423
126,0,4694,622,4336,264,3762,932,0,1352,0,3342,757,967,449,2521
127,0,4694,697,4284,287,3762,932,0,1352,0,3342,757,967,449,2521
128,0,4694,687,4291,284,3762,932,0,1352,0,3342,757,967,449,2521
129,0,4694,696,4284,286,3762,932,0,1352,0,3342,757,967,449,2521
130,0,4694,691,4285,282,3762,932,0,1352,0,3342,757,967,449,2521
133,0,4694,689,4289,284,3762,932,0,1352,0,3342,757,967,449,2521
134,0,4694,690,4286,282,3762,932,0,1352,0,3342,757,967,449,2521
135,0,4694,694,4283,283,3762,932,0,1352,0,3342,757,967,449,2521
136,1,4560,692,4153,285,3755,805,0,1282,0,3278,757,962,449,2392
137,0,4694,615,4338,259,3762,932,0,1352,0,3342,757,967,449,2521
140,1,4560,694,4152,286,3755,805,0,1282,0,3278,757,962,449,2392
141,0,4692,609,4340,257,3761,931,0,1351,0,3341,757,967,449,2519
142,1,4559,692,4148,281,3755,804,0,1281,0,3278,757,962,449,2391
143,0,4681,610,4326,255,3761,920,0,1344,0,3337,757,967,449,2508
144,1,4555,686,4149,280,3755,800,0,1280,0,3275,757,962,449,2387
147,0,4633,613,4281,261,3758,875,0,1321,0,3312,757,965,449,2462
148,1,4522,665,4132,275,3750,772,0,1260,0,3262,757,959,449,2357
149,1,4516,601,4171,256,3750,766,0,1257,0,3259,757,959,449,2351
150,0,4560,594,4217,251,3755,805,0,1282,0,3278,757,962,449,2392
151,0,4560,611,4205,256,3755,805,0,1282,0,3278,757,962,449,2392
154,0,4560,617,4203,260,3755,805,0,1282,0,3278,757,962,449,2392
155,1,4465,616,4110,261,3743,722,0,1231,0,3234,757,953,449,2306
156,0,4560,568,4233,241,3755,805,0,1282,0,3278,757,962,449,2392
157,0,4560,613,4204,257,3755,805,0,1282,0,3278,757,962,449,2392
158,0,4560,609,4206,255,3755,805,0,1282,0,3278,757,962,449,2392
161,0,4560,616,4205,261,3755,805,0,1282,0,3278,757,962,449,2392
162,0,4560,616,4203,259,3755,805,0,1282,0,3278,757,962,449,2392
163,0,4560,612,4203,255,3755,805,0,1282,0,3278,757,962,449,2392
164,1,4465,613,4110,258,3743,722,0,1231,0,3234,757,953,449,2306
165,0,4560,573,4233,246,3755,805,0,1282,0,3278,757,962,449,2392
168,0,4560,614,4205,259,3755,805,0,1282,0,3278,757,962,449,2392
169,1,4465,608,4114,257,3743,722,0,1231,0,3234,757,953,449,2306
170,0,4557,570,4231,244,3752,805,0,1280,0,3277,757,961,449,2390
171,1,4464,611,4109,256,3743,721,0,1230,0,3234,757,953,449,2305
172,0,4543,566,4219,242,3749,794,0,1273,0,3270,757,959,449,2378
175,0,4543,614,4186,257,3749,794,0,1273,0,3270,757,959,449,2378
176,0,4543,612,4187,256,3749,794,0,1273,0,3270,757,959,449,2378
177,0,4543,612,4188,257,3749,794,0,1273,0,3270,757,959,449,2378
178,1,4459,614,4102,257,3742,717,0,1229,0,3230,757,952,449,2301
179,0,4543,564,4221,242,3749,794,0,1273,0,3270,757,959,449,2378
182,0,4543,608,4193,258,3749,794,0,1273,0,3270,757,959,449,2378
183,0,4543,614,4185,256,3749,794,0,1273,0,3270,757,959,449,2378
184,0,4543,611,4188,256,3749,794,0,1273,0,3270,757,959,449,2378
185,0,4543,606,4189,252,3749,794,0,1273,0,3270,757,959,449,2378
186,0,4543,611,4190,258,3749,794,0,1273,0,3270,757,959,449,2378
189,0,4543,611,4188,256,3749,794,0,1273,0,3270,757,959,449,2378
190,1,4459,611,4106,258,3742,717,0,1229,0,3230,757,952,449,2301
191,0,4543,563,4221,241,3749,794,0,1273,0,3270,757,959,449,2378
192,0,4543,608,4190,255,3749,794,0,1273,0,3270,757,959,449,2378
193,0,4543,612,4188,257,3749,794,0,1273,0,3270,757,959,449,2378
196,0,4543,611,4188,256,3749,794,0,1273,0,3270,757,959,449,2378
197,0,4543,609,4189,255,3749,794,0,1273,0,3270,757,959,449,2378
198,0,4543,609,4189,255,3749,794,0,1273,0,3270,757,959,449,2378
199,0,4543,611,4187,255,3749,794,0,1273,0,3270,757,959,449,2378
200,1,4459,618,4103,262,3742,717,0,1229,0,3230,757,952,449,2301
203,1,4453,566,4132,245,3740,713,0,1226,0,3227,757,950,449,2297
204,0,4539,562,4217,240,3749,790,0,1271,0,3268,757,959,449,2374
205,1,4453,605,4105,257,3740,713,0,1226,0,3227,757,950,449,2297
206,0,4506,566,4185,245,3745,761,0,1254,0,3252,757,955,449,2345
207,0,4506,588,4170,252,3745,761,0,1254,0,3252,757,955,449,2345
210,0,4506,595,4165,254,3745,761,0,1254,0,3252,757,955,449,2345
211,0,4506,588,4168,250,3745,761,0,1254,0,3252,757,955,449,2345
212,0,4506,588,4167,249,3745,761,0,1254,0,3252,757,955,449,2345
213,0,4506,585,4169,248,3745,761,0,1254,0,3252,757,955,449,2345
214,1,4433,585,4100,252,3740,693,0,1214,0,3219,757,950,449,2277
217,1,4428,548,4118,238,3740,688,0,1212,0,3216,757,950,449,2272
218,0,4468,541,4159,232,3743,725,0,1231,0,3237,757,953,449,2309
219,0,4468,569,4141,242,3743,725,0,1231,0,3237,757,953,449,2309
220,0,4468,569,4143,244,3743,725,0,1231,0,3237,757,953,449,2309
221,0,4468,569,4140,241,3743,725,0,1231,0,3237,757,953,449,2309
224,0,4468,573,4141,246,3743,725,0,1231,0,3237,757,953,449,2309
225,0,4468,573,4140,245,3743,725,0,1231,0,3237,757,953,449,2309
226,0,4468,572,4140,244,3743,725,0,1231,0,3237,757,953,449,2309
227,0,4468,568,4144,244,3743,725,0,1231,0,3237,757,953,449,2309
228,0,4468,571,4140,243,3743,725,0,1231,0,3237,757,953,449,2309
231,1,4395,572,4069,246,3734,661,0,1193,0,3202,757,945,449,2244
232,0,4468,524,4171,227,3743,725,0,1231,0,3237,757,953,449,2309
233,0,4468,574,4141,247,3743,725,0,1231,0,3237,757,953,449,2309
234,0,4468,581,4137,250,3743,725,0,1231,0,3237,757,953,449,2309
235,0,4468,568,4142,242,3743,725,0,1231,0,3237,757,953,449,2309
238,0,4468,572,4142,246,3743,725,0,1231,0,3237,757,953,449,2309
239,0,4468,568,4144,244,3743,725,0,1231,0,3237,757,953,449,2309
240,0,4468,572,4140,244,3743,725,0,1231,0,3237,757,953,449,2309
241,0,4468,572,4140,244,3743,725,0,1231,0,3237,757,953,449,2309
242,0,4468,575,4141,248,3743,725,0,1231,0,3237,757,953,449,2309
245,0,4468,572,4141,245,3743,725,0,1231,0,3237,757,953,449,2309
246,1,4395,576,4066,247,3734,661,0,1193,0,3202,757,945,449,2244
247,1,4383,527,4089,233,3733,650,0,1184,0,3199,757,945,449,2232
248,1,4383,525,4090,232,3733,650,0,1184,0,3199,757,945,449,2232
249,0,4449,524,4155,230,3738,711,0,1221,0,3228,757,949,449,2294
252,0,4454,569,4127,242,3738,716,0,1224,0,3230,757,949,449,2299
253,0,4454,567,4132,245,3738,716,0,1224,0,3230,757,949,449,2299
254,0,4454,568,4130,244,3738,716,0,1224,0,3230,757,949,449,2299
255,1,4377,571,4054,248,3732,645,0,1181,0,3196,757,944,449,2227
256,0,4447,518,4157,228,3737,710,0,1219,0,3228,757,949,449,2292
259,0,4447,567,4124,244,3737,710,0,1219,0,3228,757,949,449,2292
260,1,4373,562,4052,241,3732,641,0,1178,0,3195,757,944,449,2223
261,1,4372,515,4087,230,3732,640,0,1178,0,3194,757,944,449,2222
262,1,4372,521,4087,236,3732,640,0,1178,0,3194,757,944,449,2222
263,0,4383,517,4098,232,3733,650,0,1184,0,3199,757,945,449,2232
266,1,4321,518,4032,229,3728,593,0,1151,0,3170,757,940,449,2175
267,0,4381,496,4111,226,3732,649,0,1183,0,3198,757,944,449,2231
268,1,4318,527,4027,236,3728,590,0,1148,0,3170,757,940,449,2172
269,0,4376,496,4106,226,3732,644,0,1181,0,3195,757,944,449,2226
270,0,4376,517,4091,232,3732,644,0,1181,0,3195,757,944,449,2226
273,0,4376,517,4090,231,3732,644,0,1181,0,3195,757,944,449,2226
274,0,4376,522,4090,236,3732,644,0,1181,0,3195,757,944,449,2226
275,0,4376,517,4090,231,3732,644,0,1181,0,3195,757,944,449,2226
276,1,4311,517,4027,233,3728,583,0,1144,0,3167,757,940,449,2165
277,0,4376,488,4111,223,3732,644,0,1181,0,3195,757,944,449,2226
280,1,4311,528,4022,239,3728,583,0,1144,0,3167,757,940,449,2165
281,0,4374,492,4108,226,3732,642,0,1179,0,3195,757,944,449,2224
282,0,4374,518,4087,231,3732,642,0,1179,0,3195,757,944,449,2224
283,1,4310,515,4027,232,3728,582,0,1143,0,3167,757,940,449,2164
284,0,4368,490,4102,224,3732,636,0,1178,0,3190,757,944,449,2218
287,0,4369,518,4082,231,3732,637,0,1178,0,3191,757,944,449,2219
288,0,4369,519,4081,231,3732,637,0,1178,0,3191,757,944,449,2219
289,0,4369,521,4082,234,3732,637,0,1178,0,3191,757,944,449,2219
290,0,4369,514,4083,228,3732,637,0,1178,0,3191,757,944,449,2219
291,0,4369,516,4084,231,3732,637,0,1178,0,3191,757,944,449,2219
294,0,4369,521,4082,234,3732,637,0,1178,0,3191,757,944,449,2219
295,1,4308,512,4024,228,3728,580,0,1141,0,3167,757,940,449,2162
296,0,4368,489,4103,224,3732,636,0,1178,0,3190,757,944,449,2218
297,1,4308,520,4023,235,3728,580,0,1141,0,3167,757,940,449,2162
298,0,4366,482,4105,221,3732,634,0,1178,0,3188,757,944,449,2216
301,0,4366,512,4082,228,3732,634,0,1178,0,3188,757,944,449,2216
302,1,4307,511,4023,227,3727,580,0,1140,0,3167,757,940,449,2161
303,0,4358,480,4097,219,3732,626,0,1172,0,3186,757,944,449,2208
304,0,4358,511,4076,229,3732,626,0,1172,0,3186,757,944,449,2208
305,1,4301,512,4023,234,3727,574,0,1136,0,3165,757,940,449,2155
308,0,4329,484,4068,223,3729,600,0,1154,0,3175,757,941,449,2182
309,1,4271,497,4000,226,3724,547,0,1121,0,3150,757,937,449,2128
310,0,4309,473,4055,219,3727,582,0,1142,0,3167,757,940,449,2163
311,0,4309,487,4047,225,3727,582,0,1142,0,3167,757,940,449,2163
312,0,4309,487,4046,224,3727,582,0,1142,0,3167,757,940,449,2163
315,0,4309,491,4046,228,3727,582,0,1142,0,3167,757,940,449,2163
316,1,4253,488,3992,227,3723,530,0,1115,0,3138,757,936,449,2111
317,1,4249,471,3995,217,3723,526,0,1113,0,3136,757,936,449,2107
318,0,4307,476,4051,220,3727,580,0,1140,0,3167,757,940,449,2161
319,1,4246,481,3989,224,3723,523,0,1112,0,3134,757,936,449,2104
322,1,4245,471,3995,221,3723,522,0,1111,0,3134,757,936,449,2103
323,0,4280,473,4028,221,3723,557,0,1124,0,3156,757,936,449,2138
324,0,4280,479,4024,223,3723,557,0,1124,0,3156,757,936,449,2138
325,0,4280,486,4020,226,3723,557,0,1124,0,3156,757,936,449,2138
326,0,4280,488,4021,229,3723,557,0,1124,0,3156,757,936,449,2138
329,1,4238,483,3980,225,3722,516,0,1104,0,3134,757,935,449,2097
330,1,4236,469,3987,220,3722,514,0,1102,0,3134,757,935,449,2095
331,0,4249,470,4001,222,3723,526,0,1113,0,3136,757,936,449,2107
332,1,4213,477,3957,221,3718,495,0,1088,0,3125,757,933,449,2074
333,0,4249,457,4010,218,3723,526,0,1113,0,3136,757,936,449,2107
336,1,4213,468,3961,216,3718,495,0,1088,0,3125,757,933,449,2074
337,0,4245,461,4004,220,3723,522,0,1111,0,3134,757,936,449,2103
338,1,4211,472,3959,220,3717,494,0,1087,0,3124,757,933,449,2072
339,0,4242,457,4003,218,3722,520,0,1108,0,3134,757,935,449,2101
340,1,4211,470,3960,219,3717,494,0,1087,0,3124,757,933,449,2072
343,0,4234,456,3995,217,3720,514,0,1100,0,3134,757,935,449,2093
344,0,4234,470,3984,220,3720,514,0,1100,0,3134,757,935,449,2093
345,1,4207,475,3958,226,3717,490,0,1086,0,3121,757,933,449,2068
346,1,4206,450,3972,216,3717,489,0,1086,0,3120,757,933,449,2067
347,1,4206,456,3968,218,3717,489,0,1086,0,3120,757,933,449,2067
350,0,4212,458,3975,221,3717,495,0,1087,0,3125,757,933,449,2073
351,0,4212,458,3972,218,3717,495,0,1087,0,3125,757,933,449,2073
352,1,4191,464,3952,225,3714,477,0,1079,0,3112,757,930,449,2055
353,0,4211,451,3976,216,3717,494,0,1087,0,3124,757,933,449,2072
354,1,4189,453,3949,213,3714,475,0,1079,0,3110,757,930,449,2053
357,0,4211,457,3972,218,3717,494,0,1087,0,3124,757,933,449,2072
358,0,4211,458,3970,217,3717,494,0,1087,0,3124,757,933,449,2072
359,1,4189,457,3950,218,3714,475,0,1079,0,3110,757,930,449,2053
360,1,4188,448,3954,214,3714,474,0,1078,0,3110,757,930,449,2052
361,0,4205,451,3969,215,3717,488,0,1085,0,3120,757,933,449,2066
364,0,4206,455,3970,219,3717,489,0,1086,0,3120,757,933,449,2067
